ABBREVIATION	COUNT_NOT_MISSING	PERCENTAGE_NOT_MISSING	COUNT_MISSING	PERCENTAGE_MISSING	COUNT_TOTAL
b-pvk+t	761639	0.0983%	15235022	1.96609%	15996661
-cv19nho	433585	0.0560%	4931530	0.63642%	5365115
p-crp	14796881	1.9095%	4555157	0.58785%	19352038
u-baktvi	412023	0.0532%	4330522	0.55886%	4742545
u-kemseul	263008	0.0339%	3640352	0.46979%	3903360
pt-ekg-12	122484	0.0158%	3329759	0.42971%	3452243
b-pvk	35684	0.0046%	2573729	0.33214%	2609413
u-gluk-o	812903	0.1049%	2113187	0.27271%	2926090
u-keto-o	861080	0.1111%	2056554	0.26540%	2917634
b-pvkt	647	0.0001%	1983265	0.25594%	1983912
u-nitr-o	889452	0.1148%	1966202	0.25374%	2855654
b-diffi	330307	0.0426%	1896366	0.24473%	2226673
u-leuk-o	918109	0.1185%	1780889	0.22983%	2698998
u-solut	257054	0.0332%	1625183	0.20973%	1882237
b-baktvi	190376	0.0246%	1480340	0.19104%	1670716
p-vrab-o	17855	0.0023%	1367368	0.17646%	1385223
b-tvk	39456	0.0051%	1320570	0.17042%	1360026
u-alb-o	673104	0.0869%	1301803	0.16800%	1974907
u-baktjvi	254425	0.0328%	1165419	0.15040%	1419844
u-eryt-o	679372	0.0877%	1086658	0.14023%	1766030
b-xkoe	130293	0.0168%	1065831	0.13755%	1196124
b-pvk+tkd	12561	0.0016%	1032257	0.13321%	1044818
fp-lipidit	94445	0.0122%	920878	0.11884%	1015323
u-bakt	377572	0.0487%	881696	0.11378%	1259268
ps-strvi	112284	0.0145%	842930	0.10878%	955214
ts-pad-1	54537	0.0070%	793883	0.10245%	848420
s-ca-ion	1063028	0.1372%	662317	0.08547%	1725345
p-k	20955616	2.7043%	648097	0.08364%	21603713
s-crp	702458	0.0907%	637712	0.08230%	1340170
e-aborh	70671	0.0091%	629058	0.08118%	699729
u-prot-o	318326	0.0411%	597310	0.07708%	915636
ps-straag	33134	0.0043%	583690	0.07533%	616824
b-eryt	32233249	4.1597%	568138	0.07332%	32801387
b-leuk	31725206	4.0942%	566703	0.07313%	32291909
pt-ekg-atk	34843	0.0045%	547914	0.07071%	582757
e-vrtark	127470	0.0165%	518290	0.06689%	645760
s-hivagab	90489	0.0117%	510427	0.06587%	600916
s-vrab-o	193845	0.0250%	505465	0.06523%	699310
u-hb-o	353803	0.0457%	478046	0.06169%	831849
-mrsavi	16447	0.0021%	470200	0.06068%	486647
pt-gfreepi	8621664	1.1126%	468131	0.06041%	9089795
u-tutkesi	9730	0.0013%	468115	0.06041%	477845
u-chtrnho	61903	0.0080%	467522	0.06033%	529425
cv19nho	3579	0.0005%	461281	0.05953%	464860
pt-papa-1	22770	0.0029%	450157	0.05809%	472927
u-gcnho	47237	0.0061%	433757	0.05598%	480994
fs-lipidit	49576	0.0064%	426643	0.05506%	476219
p-tnt	1590569	0.2053%	400090	0.05163%	1990659
u-ctgcnho	57959	0.0075%	381053	0.04918%	439012
e-mcv	32442569	4.1867%	378165	0.04880%	32820734
e-mch	32391249	4.1801%	378049	0.04879%	32769298
s-psa-suh	68650	0.0089%	377907	0.04877%	446557
pu-baktvi1	83035	0.0107%	370651	0.04783%	453686
u-solu.	2112	0.0003%	367579	0.04744%	369691
NA	468256	0.0604%	364530	0.04704%	832786
s-hbsag	51265	0.0066%	360174	0.04648%	411439
b-trom	31626024	4.0814%	347279	0.04482%	31973303
u-albkre	571014	0.0737%	335326	0.04327%	906340
p-gfreepi	141459	0.0183%	331061	0.04272%	472520
s-ttgaba	244898	0.0316%	325639	0.04202%	570537
pu-baktvi2	74209	0.0096%	302548	0.03904%	376757
e-mchc	23493060	3.0318%	302481	0.03904%	23795541
pt-ekg-oma	3045	0.0004%	300656	0.03880%	303701
e-rdw	19004745	2.4526%	298963	0.03858%	19303708
e-rdw	53211	0.0069%	298963	0.03858%	352174
p-inr	2573886	0.3322%	298088	0.03847%	2871974
p-krea	21797503	2.8130%	297389	0.03838%	22094892
u-opiaa-o	26880	0.0035%	286911	0.03703%	313791
b-hkr	32893386	4.2449%	284298	0.03669%	33177684
u-canna-o	34526	0.0045%	279195	0.03603%	313721
b-hb	32620242	4.2097%	273844	0.03534%	32894086
ottotapa	19947	0.0026%	272437	0.03516%	292384
-chtrnho	60148	0.0078%	267661	0.03454%	327809
u-bendi-o	45441	0.0059%	267314	0.03450%	312755
u-koka-o	24961	0.0032%	266849	0.03444%	291810
u-alb	622739	0.0804%	265691	0.03429%	888430
s-hcvab	43970	0.0057%	263812	0.03405%	307782
u-amfet-o	30648	0.0040%	263508	0.03401%	294156
s-b12-tc2	509639	0.0658%	261348	0.03373%	770987
p-tni	754139	0.0973%	259620	0.03350%	1013759
ab-vekaasl	406	0.0001%	257532	0.03323%	257938
p-na	21000451	2.7101%	255063	0.03292%	21255514
b-erblast	1075546	0.1388%	253253	0.03268%	1328799
p-gluk	4001677	0.5164%	250431	0.03232%	4252108
p-psa-suh	340555	0.0439%	237254	0.03062%	577809
s-trpaab	30887	0.0040%	234749	0.03029%	265636
p-alat	12318263	1.5897%	231382	0.02986%	12549645
pt-gfre-md	154532	0.0199%	231362	0.02986%	385894
ts-padgast	17445	0.0023%	218699	0.02822%	236144
-infanho	26430	0.0034%	218534	0.02820%	244964
u-bupre-o	36638	0.0047%	214093	0.02763%	250731
ts-pad-3	31438	0.0041%	210110	0.02711%	241548
p-ca-ion	61504	0.0079%	204102	0.02634%	265606
b-pvk+tmd	28912	0.0037%	196522	0.02536%	225434
u-menetel	1819	0.0002%	193615	0.02499%	195434
cb-he-tase	534	0.0001%	191038	0.02465%	191572
-gcnho	45225	0.0058%	184211	0.02377%	229436
-infbnho	20209	0.0026%	181788	0.02346%	201997
u-veri-o	84963	0.0110%	180417	0.02328%	265380
pt-gluk-r1	16644	0.0021%	177048	0.02285%	193692
u-huum-o	14029	0.0018%	175594	0.02266%	189623
-ctgcnho	39360	0.0051%	175417	0.02264%	214777
s-ana	77416	0.0100%	174067	0.02246%	251483
ts-padcolo	19455	0.0025%	172790	0.02230%	192245
u-ph	2064826	0.2665%	170934	0.02206%	2235760
s-kipa	240	0.0000%	165142	0.02131%	165382
-rsvnho	21426	0.0028%	159570	0.02059%	180996
u-suhti	1194799	0.1542%	158332	0.02043%	1353131
b-neut	5752671	0.7424%	156194	0.02016%	5908865
ab-be	890560	0.1149%	156127	0.02015%	1046687
f-cldtnho	18387	0.0024%	153304	0.01978%	171691
u-suhtih	398023	0.0514%	152669	0.01970%	550692
l-promyel	69126	0.0089%	152475	0.01968%	221601
l-myelos	64916	0.0084%	152386	0.01967%	217302
l-blastit	47988	0.0062%	152331	0.01966%	200319
cb-be	378548	0.0489%	148289	0.01914%	526837
b-ghb-a1c	436046	0.0563%	147722	0.01906%	583768
b-vrab-gr	16478	0.0021%	143756	0.01855%	160234
s-prot-fr	28272	0.0036%	142302	0.01836%	170574
f-salmvi	18914	0.0024%	141431	0.01825%	160345
u-metad-o	22205	0.0029%	141321	0.01824%	163526
-cv19ag5	5298	0.0007%	139969	0.01806%	145267
f-hhb-o	26662	0.0034%	138526	0.01788%	165188
u-bakt-vi	5797	0.0007%	136625	0.01763%	142422
s-psa-v	74763	0.0096%	134210	0.01732%	208973
s-hbcab	33035	0.0043%	132331	0.01708%	165366
s-emaba	16641	0.0021%	129459	0.01671%	146100
fs-ca-ion	117087	0.0151%	127990	0.01652%	245077
f-baktvi1	9794	0.0013%	126050	0.01627%	135844
b-lakt-d	15518	0.0020%	124663	0.01609%	140181
p-bil	3840985	0.4957%	124480	0.01606%	3965465
s-ccpab	170343	0.0220%	124245	0.01603%	294588
s-borrab	12624	0.0016%	119189	0.01538%	131813
cb-het-ion	15142	0.0020%	114790	0.01481%	129932
pt-fvspido	7143	0.0009%	111646	0.01441%	118789
ts-pad-ih	11472	0.0015%	110260	0.01423%	121732
sk-sienvi	23584	0.0030%	106741	0.01378%	130325
vb-be	385557	0.0498%	106243	0.01371%	491800
oma-crp	76145	0.0098%	104189	0.01345%	180334
f-hepyag	18084	0.0023%	101817	0.01314%	119901
pt-fvspird	9417	0.0012%	100481	0.01297%	109898
b-baso	3442157	0.4442%	99926	0.01290%	3542083
-inabrsv	8444	0.0011%	99918	0.01289%	108362
s-borrabg	27818	0.0036%	99084	0.01279%	126902
s-iglc-v	129	0.0000%	97530	0.01259%	97659
p-tt-inr	4656033	0.6009%	96550	0.01246%	4752583
l-metamye	46111	0.0060%	94069	0.01214%	140180
cp-crp-hy	192742	0.0249%	93719	0.01209%	286461
u-leuk	1568259	0.2024%	91070	0.01175%	1659329
-hpvnho	5083	0.0007%	90760	0.01171%	95843
vb-he-tase	23933	0.0031%	90226	0.01164%	114159
s-igakeli	22122	0.0029%	87464	0.01129%	109586
p-psa-v/t	747	0.0001%	87363	0.01127%	88110
p-afos	6692309	0.8636%	87173	0.01125%	6779482
p-psa	863128	0.1114%	85435	0.01103%	948563
u-baktseu	8444	0.0011%	85084	0.01098%	93528
p-cmvnh	27275	0.0035%	82841	0.01069%	110116
infbnho	978	0.0001%	82075	0.01059%	83053
s-borrabm	44540	0.0057%	81959	0.01058%	126499
-tbvi	1349	0.0002%	81183	0.01048%	82532
u-syto	10942	0.0014%	81045	0.01046%	91987
ts-pad-4	15442	0.0020%	80665	0.01041%	96107
p-rf	44705	0.0058%	80271	0.01036%	124976
b-monos	3073307	0.3966%	80191	0.01035%	3153498
b-monos	4858	0.0006%	80191	0.01035%	85049
pt-fvspiro	3740	0.0005%	79331	0.01024%	83071
b-diffi-kd	897	0.0001%	79229	0.01022%	80126
b-ly	2776535	0.3583%	78498	0.01013%	2855033
b-ly	1571	0.0002%	78498	0.01013%	80069
s-mypnab	9869	0.0013%	78301	0.01010%	88170
-baktvr	3136	0.0004%	77482	0.01000%	80618
fe-folaat	404708	0.0522%	77054	0.00994%	481762
p-fidd	367703	0.0475%	76660	0.00989%	444363
s-tr1seul	2573	0.0003%	74467	0.00961%	77040
-infabag	1475	0.0002%	73990	0.00955%	75465
p-crphoi	98243	0.0127%	73170	0.00944%	171413
fl-strbvi	3809	0.0005%	72752	0.00939%	76561
-infbag	114	0.0000%	72740	0.00939%	72854
b-hba1c	4784590	0.6175%	72445	0.00935%	4857035
-infaag	426	0.0001%	72404	0.00934%	72830
s-dgpabg	20301	0.0026%	72286	0.00933%	92587
b-bio-0	7447	0.0010%	72132	0.00931%	79579
ab-ph	962279	0.1242%	71408	0.00922%	1033687
cb-tt-inrp	19776	0.0026%	70753	0.00913%	90529
b-eos	3474588	0.4484%	70422	0.00909%	3545010
u-prot	80350	0.0104%	69380	0.00895%	149730
u-hcg-o	11640	0.0015%	67454	0.00870%	79094
fp-kol-ldl	4819687	0.6220%	66808	0.00862%	4886495
s-hcg	42205	0.0054%	66449	0.00858%	108654
sk-padihot	3465	0.0004%	65598	0.00847%	69063
p-crp-hy	82674	0.0107%	65403	0.00844%	148077
s-Ã¤itseul	11774	0.0015%	65313	0.00843%	77087
p-tsh	4295934	0.5544%	64316	0.00830%	4360250
rsvnho	1041	0.0001%	63928	0.00825%	64969
-adennho	1784	0.0002%	63902	0.00825%	65686
s-keliseu	17723	0.0023%	63839	0.00824%	81562
u-tutk-1	4853	0.0006%	63643	0.00821%	68496
-ncovnho	2310	0.0003%	63508	0.00820%	65818
b-k	331214	0.0427%	63125	0.00815%	394339
s-rf	85619	0.0110%	63014	0.00813%	148633
pt-gluk-r6	311	0.0000%	62777	0.00810%	63088
s-monab-o	7590	0.0010%	62639	0.00808%	70229
b-tnt-o	16535	0.0021%	61431	0.00793%	77966
b-la	4249395	0.5484%	61266	0.00791%	4310661
ab-hb	582368	0.0752%	61074	0.00788%	643442
p-alb	2369055	0.3057%	60796	0.00785%	2429851
fs-ph	146537	0.0189%	60788	0.00784%	207325
ly-hlab27	11028	0.0014%	60506	0.00781%	71534
p-tnt-vt	14202	0.0018%	60150	0.00776%	74352
s-pr3ab	17208	0.0022%	59999	0.00774%	77207
ab-vekaas	108	0.0000%	59962	0.00774%	60070
u-baktjvi.	8099	0.0010%	59423	0.00767%	67522
s-mypnabm	28563	0.0037%	58638	0.00757%	87201
s-keliab	239	0.0000%	58347	0.00753%	58586
l-metmye	5111	0.0007%	58252	0.00752%	63363
b-erybla	2587593	0.3339%	57233	0.00739%	2644826
b-baktjvi	13351	0.0017%	56909	0.00734%	70260
b-hb-met	236001	0.0305%	56822	0.00733%	292823
s-enaab	12861	0.0017%	56615	0.00731%	69476
u-eryt	1573157	0.2030%	56299	0.00727%	1629456
f-noronho	4953	0.0006%	56055	0.00723%	61008
ab-ca-ion	212980	0.0275%	55967	0.00722%	268947
b-angap	206431	0.0266%	55824	0.00720%	262255
u-baktevi	1444	0.0002%	55648	0.00718%	57092
b-hb-co	244784	0.0316%	55291	0.00714%	300075
pt-polamb	3364	0.0004%	54753	0.00707%	58117
fp-gluk	5764444	0.7439%	54444	0.00703%	5818888
b-na	339965	0.0439%	54293	0.00701%	394258
f-para-o	6404	0.0008%	54134	0.00699%	60538
-h-ind	107726	0.0139%	53982	0.00697%	161708
b-crpp	66205	0.0085%	52663	0.00680%	118868
-hmpvnho	1439	0.0002%	52208	0.00674%	53647
p-asat	1690467	0.2182%	51741	0.00668%	1742208
u-metam-o	9884	0.0013%	51094	0.00659%	60978
f-shigvi	2335	0.0003%	51077	0.00659%	53412
f-yersvi	2767	0.0004%	50988	0.00658%	53755
p-crp-o	90762	0.0117%	50575	0.00653%	141337
b-be	142945	0.0184%	50568	0.00653%	193513
u-albkrea	72816	0.0094%	50135	0.00647%	122951
nitr-o	5935	0.0008%	49786	0.00642%	55721
li-solut	4939	0.0006%	49294	0.00636%	54233
f-campvi	3213	0.0004%	48965	0.00632%	52178
e-coomb-o	6175	0.0008%	48696	0.00628%	54871
ps-str-vi	1417	0.0002%	48591	0.00627%	50008
alb-o	7210	0.0009%	48510	0.00626%	55720
b-laktteh	273473	0.0353%	48237	0.00623%	321710
cp-gluk-hy	55128	0.0071%	47842	0.00617%	102970
pu-sienvi	6241	0.0008%	47351	0.00611%	53592
p-hcg	69092	0.0089%	47097	0.00608%	116189
e-abovarm	1388	0.0002%	46473	0.00600%	47861
ts-pad-2	1523	0.0002%	46104	0.00595%	47627
ab-pco2	989988	0.1278%	46002	0.00594%	1035990
vb-ph	389710	0.0503%	45451	0.00587%	435161
fp-trigly	4291489	0.5538%	45416	0.00586%	4336905
s-ttgabg	18690	0.0024%	45091	0.00582%	63781
sy-kide-o	5540	0.0007%	44963	0.00580%	50503
vb-het-ion	8981	0.0012%	44885	0.00579%	53866
u-gluk	1522	0.0002%	44677	0.00577%	46199
pt-gfre	5011774	0.6468%	44607	0.00576%	5056381
p-t4-v	3106610	0.4009%	44463	0.00574%	3151073
infanho	329	0.0000%	43871	0.00566%	44200
f-baktvip	12449	0.0016%	43770	0.00565%	56219
fp-kol	4460728	0.5757%	43727	0.00564%	4504455
s-tpoab	70363	0.0091%	43689	0.00564%	114052
b-retik	222334	0.0287%	43001	0.00555%	265335
oma-pt-ekg	1702	0.0002%	42423	0.00547%	44125
s-ebvab	5149	0.0007%	41966	0.00542%	47115
leuk-o	13970	0.0018%	41793	0.00539%	55763
s-chpnab	4129	0.0005%	41770	0.00539%	45899
s-cmvab	5246	0.0007%	41559	0.00536%	46805
fp-kol-hdl	4236675	0.5467%	41487	0.00535%	4278162
s-dpteroe	38448	0.0050%	40932	0.00528%	79380
pt-klr-tje	189	0.0000%	40537	0.00523%	40726
ua-be	9940	0.0013%	40333	0.00521%	50273
f-calpro	384953	0.0497%	40016	0.00516%	424969
f-baktnho	1296	0.0002%	39503	0.00510%	40799
ps-infaag	4967	0.0006%	39390	0.00508%	44357
ps-infbag	4967	0.0006%	39383	0.00508%	44350
-bokanho	1576	0.0002%	39198	0.00506%	40774
u-epit	819810	0.1058%	39063	0.00504%	858873
s-anca	3387	0.0004%	38907	0.00502%	42294
u-gluk-hy	2878	0.0004%	38788	0.00501%	41666
p-psa-v	252675	0.0326%	38658	0.00499%	291333
b-crp-vt	61252	0.0079%	38629	0.00499%	99881
p-bil-kj	438823	0.0566%	38254	0.00494%	477077
s-hcg-o	8247	0.0011%	37748	0.00487%	45995
f-paranho	5121	0.0007%	37378	0.00482%	42499
s-dnanab	24990	0.0032%	37185	0.00480%	62175
p-crp-vt	57902	0.0075%	37133	0.00479%	95035
p-ebvnh	9533	0.0012%	36945	0.00477%	46478
b-diffmik	361	0.0000%	36882	0.00476%	37243
s-immfix	7258	0.0009%	36845	0.00475%	44103
bm-mggfe	4642	0.0006%	36813	0.00475%	41455
u-nitr-hy	5528	0.0007%	36775	0.00475%	42303
u-kemseul,ph	11406	0.0015%	36770	0.00475%	48176
u-keto-hy	5154	0.0007%	36683	0.00473%	41837
l-baso	2577250	0.3326%	36650	0.00473%	2613900
s-ebvabm	6930	0.0009%	36627	0.00473%	43557
s-cmvabm	6495	0.0008%	36481	0.00471%	42976
s-hepyab	3568	0.0005%	36380	0.00469%	39948
-pin1nho	1375	0.0002%	36156	0.00467%	37531
-rvirnho	420	0.0001%	36142	0.00466%	36562
u-trama-o	8247	0.0011%	36134	0.00466%	44381
-pin4nho	1386	0.0002%	36133	0.00466%	37519
b-cl	226271	0.0292%	36122	0.00466%	262393
-mypnnho	731	0.0001%	36114	0.00466%	36845
-pin2nho	1449	0.0002%	36083	0.00466%	37532
s-pujoe	33344	0.0043%	35954	0.00464%	69298
p-ca-albk	319292	0.0412%	35933	0.00464%	355225
s-ph	840522	0.1085%	35902	0.00463%	876424
s-siliab	10221	0.0013%	35883	0.00463%	46104
-pin3nho	1739	0.0002%	35781	0.00462%	37520
oma-p-crp	27150	0.0035%	35720	0.00461%	62870
s-cea	240850	0.0311%	35319	0.00456%	276169
s-mitoab	6091	0.0008%	35159	0.00454%	41250
s-kardab	5525	0.0007%	35047	0.00452%	40572
ps-strjvi	218	0.0000%	34961	0.00451%	35179
s-hbvpak	20457	0.0026%	34602	0.00447%	55059
pt-kiire	614	0.0001%	34198	0.00441%	34812
cb-ph	496849	0.0641%	34164	0.00441%	531013
oma-inr	21199	0.0027%	34093	0.00440%	55292
u-trisy-o	7697	0.0010%	33714	0.00435%	41411
ts-fnab	2520	0.0003%	33671	0.00435%	36191
s-mpoab	3404	0.0004%	33092	0.00427%	36496
s-ca-iona	892654	0.1152%	32907	0.00425%	925561
ab-hbo2sat	636869	0.0822%	32637	0.00421%	669506
ikÃ¤riski	10108	0.0013%	32619	0.00421%	42727
s-c-anca	1708	0.0002%	32603	0.00421%	34311
p-tnt-o	10573	0.0014%	32506	0.00419%	43079
-vrevi	909	0.0001%	32487	0.00419%	33396
-bopenho	179	0.0000%	32324	0.00417%	32503
s-ssbab	7349	0.0009%	32021	0.00413%	39370
pika-inr	32916	0.0042%	31998	0.00413%	64914
s-timotee	38525	0.0050%	31864	0.00411%	70389
s-emabg	3889	0.0005%	31522	0.00407%	35411
u-syto-1	227	0.0000%	31234	0.00403%	31461
pt-ekg-24h	1186	0.0002%	31165	0.00402%	32351
down-risuh	10518	0.0014%	31163	0.00402%	41681
-evirnho	1400	0.0002%	31012	0.00400%	32412
p-gt	2386504	0.3080%	30989	0.00400%	2417493
ex-baktvi	4278	0.0006%	30969	0.00400%	35247
s-p-anca	3469	0.0004%	30861	0.00398%	34330
s-koivue	44651	0.0058%	30857	0.00398%	75508
ab-he-tase	2010	0.0003%	30794	0.00397%	32804
ps-straohy	4271	0.0006%	30778	0.00397%	35049
ts-pad-tk	6328	0.0008%	30752	0.00397%	37080
s-mpoabg	10102	0.0013%	30544	0.00394%	40646
b-tbifng	20559	0.0027%	30382	0.00392%	50941
pt-papa-tk	2942	0.0004%	29909	0.00386%	32851
u-osmole	349080	0.0450%	29893	0.00386%	378973
pt-fvspio	667	0.0001%	29863	0.00385%	30530
li-baktvi	2408	0.0003%	29733	0.00384%	32141
s-chpnabm	13823	0.0018%	29702	0.00383%	43525
s-allige	39560	0.0051%	29685	0.00383%	69245
l-eos	2584061	0.3335%	29673	0.00383%	2613734
p-probnp	879768	0.1135%	29587	0.00382%	909355
u-kemseul,u-ph	2159	0.0003%	29348	0.00379%	31507
-candvi	5511	0.0007%	29334	0.00379%	34845
s-hepyabg	28685	0.0037%	29257	0.00378%	57942
tri18risuh	9914	0.0013%	29232	0.00377%	39146
u-levyep	589433	0.0761%	29217	0.00377%	618650
u-prot-hy	14246	0.0018%	29135	0.00376%	43381
-tbnho	3085	0.0004%	28882	0.00373%	31967
s-ige-pse	3580	0.0005%	28757	0.00371%	32337
s-havab	4325	0.0006%	28576	0.00369%	32901
s-smab	8420	0.0011%	28408	0.00367%	36828
ab-o2-vol%	542554	0.0700%	28364	0.00366%	570918
pt-enmg-2	528	0.0001%	28307	0.00365%	28835
fs-rf	8192	0.0011%	28282	0.00365%	36474
u-alb-mi	69875	0.0090%	27985	0.00361%	97860
s-mypnabg	55423	0.0072%	27782	0.00359%	83205
ph	302232	0.0390%	27713	0.00358%	329945
crp-pika	86158	0.0111%	27614	0.00356%	113772
p-antifxa	99970	0.0129%	27408	0.00354%	127378
pika-crp	52884	0.0068%	27293	0.00352%	80177
s-tpha	4028	0.0005%	27221	0.00351%	31249
u-fenta-o	6411	0.0008%	26996	0.00348%	33407
sy-diffi	4665	0.0006%	26712	0.00345%	31377
ab-ahco3	481080	0.0621%	26381	0.00340%	507461
s-clahere	3998	0.0005%	26185	0.00338%	30183
s-rnpab	10861	0.0014%	26015	0.00336%	36876
p-hiv1nh	9102	0.0012%	25939	0.00335%	35041
s-ema	3758	0.0005%	25927	0.00335%	29685
-inabnho	1577	0.0002%	25863	0.00334%	27440
cb-pco2	502166	0.0648%	25766	0.00333%	527932
ex-tbvrvi	7794	0.0010%	25560	0.00330%	33354
u-huumlct	14098	0.0018%	25556	0.00330%	39654
s-crp-o	36163	0.0047%	25508	0.00329%	61671
s-hevohie	17947	0.0023%	25497	0.00329%	43444
du-prot-fr	3905	0.0005%	25491	0.00329%	29396
-lepnnho	162	0.0000%	25351	0.00327%	25513
s-havabm	3147	0.0004%	25201	0.00325%	28348
u-leuk-hy	18638	0.0024%	25010	0.00323%	43648
ts-padpros	3394	0.0004%	24939	0.00322%	28333
-rsvag	631	0.0001%	24834	0.00320%	25465
b-crp-o	40494	0.0052%	24609	0.00318%	65103
ua-vekaas	506	0.0001%	24583	0.00317%	25089
s-tshrab	39428	0.0051%	24557	0.00317%	63985
s-tnt	547	0.0001%	24487	0.00316%	25034
u-pienep	394711	0.0509%	24392	0.00315%	419103
ts-pad-ev	909	0.0001%	24360	0.00314%	25269
pt-pef-pa	1320	0.0002%	24182	0.00312%	25502
p-etoh	41092	0.0053%	23812	0.00307%	64904
l-neut	1360897	0.1756%	23545	0.00304%	1384442
sy-solut	14427	0.0019%	23477	0.00303%	37904
s-hbsab	40675	0.0052%	23424	0.00302%	64099
-rinonho	4831	0.0006%	23390	0.00302%	28221
-baktnho	9288	0.0012%	23356	0.00301%	32644
li-unï¿½kï¿½-o	4463	0.0006%	23339	0.00301%	27802
-adenag	237	0.0000%	23239	0.00300%	23476
s-munavae	20323	0.0026%	23235	0.00300%	43558
ps-baktvi	1575	0.0002%	23187	0.00299%	24762
-strjvi	7546	0.0010%	23095	0.00298%	30641
-hhpvnho	9816	0.0013%	22927	0.00296%	32743
p-trombot	3602	0.0005%	22923	0.00296%	26525
-tbvrvi	3740	0.0005%	22667	0.00293%	26407
s-keliseul	494	0.0001%	22625	0.00292%	23119
cb-crp	2044	0.0003%	22563	0.00291%	24607
-koronho	1275	0.0002%	22535	0.00291%	23810
u-krea	1156647	0.1493%	22434	0.00290%	1179081
p-ca	776968	0.1003%	22281	0.00288%	799249
u-eryt-hy	20256	0.0026%	22218	0.00287%	42474
s-ssaab	10021	0.0013%	22120	0.00285%	32141
-chpnnho	502	0.0001%	22038	0.00284%	22540
crp	31046	0.0040%	21996	0.00284%	53042
s-turskae	10528	0.0014%	21989	0.00284%	32517
-cv19pika	112	0.0000%	21973	0.00284%	22085
s-kisshie	23319	0.0030%	21972	0.00284%	45291
vb-vekaas	1149	0.0001%	21918	0.00283%	23067
li-diffi	4744	0.0006%	21866	0.00282%	26610
pt-meeting	5181	0.0007%	21646	0.00279%	26827
-koroc43	156	0.0000%	21633	0.00279%	21789
kvoc43nho	123	0.0000%	21536	0.00278%	21659
s-maitoe	20495	0.0026%	21443	0.00277%	41938
fl-strbnho	23712	0.0031%	21363	0.00276%	45075
-syto	1205	0.0002%	21329	0.00275%	22534
u-oksik-o	8472	0.0011%	21121	0.00273%	29593
s-koirhie	24027	0.0031%	21103	0.00272%	45130
u-tutk-2	488	0.0001%	21054	0.00272%	21542
f-hb-o	2863	0.0004%	20957	0.00270%	23820
-sienvr	994	0.0001%	20909	0.00270%	21903
l-monos	1331897	0.1719%	20903	0.00270%	1352800
-kornl63	130	0.0000%	20866	0.00269%	20996
s-cladhee	26645	0.0034%	20810	0.00269%	47455
crpvieri	30654	0.0040%	20619	0.00266%	51273
p-amyl	1337244	0.1726%	20388	0.00263%	1357632
ab-ca-i7.4	247277	0.0319%	20363	0.00263%	267640
b-diff-mik	107	0.0000%	20354	0.00263%	20461
-sienvi	3506	0.0005%	20264	0.00262%	23770
s-metnor	112	0.0000%	20240	0.00261%	20352
fl-baktvr	8086	0.0010%	20125	0.00260%	28211
s-puumab	2099	0.0003%	20095	0.00259%	22194
s-alat	1241417	0.1602%	19953	0.00257%	1261370
b-fv-d	3699	0.0005%	19936	0.00257%	23635
u-bact	1361	0.0002%	19789	0.00255%	21150
p-pi	414003	0.0534%	19710	0.00254%	433713
-poccv19	51701	0.0067%	19698	0.00254%	71399
s-ige-sse	14082	0.0018%	19608	0.00253%	33690
ca-ion	218073	0.0281%	19485	0.00251%	237558
u-nitri-o	2430	0.0003%	19445	0.00251%	21875
s-psa	389208	0.0502%	19390	0.00250%	408598
s-tygl	20280	0.0026%	19369	0.00250%	39649
p-mg	632964	0.0817%	19319	0.00249%	652283
s-toxoab	1947	0.0003%	19215	0.00248%	21162
gt-cdt-ind	26324	0.0034%	19209	0.00248%	45533
ps-straolb	2790	0.0004%	19131	0.00247%	21921
u-huumtof	422	0.0001%	19075	0.00246%	19497
s-bopeab	1791	0.0002%	18981	0.00245%	20772
s-igg-sc	965	0.0001%	18917	0.00244%	19882
s-vzvabm	3475	0.0004%	18867	0.00243%	22342
ab-po2	1016136	0.1311%	18853	0.00243%	1034989
s-afos-is	1729	0.0002%	18838	0.00243%	20567
s-scl70ab	5602	0.0007%	18823	0.00243%	24425
fl-hiivavi	3617	0.0005%	18606	0.00240%	22223
campnho	739	0.0001%	18601	0.00240%	19340
li-unÃ¤kÃ¶-n	4933	0.0006%	18598	0.00240%	23531
b-eos_	227602	0.0294%	18501	0.00239%	246103
b-eos_	4902	0.0006%	18501	0.00239%	23403
etecnho	562	0.0001%	18380	0.00237%	18942
p-ca-iona	1032572	0.1333%	18364	0.00237%	1050936
yersnho	605	0.0001%	18339	0.00237%	18944
s-cmvabg	26942	0.0035%	18269	0.00236%	45211
s-dgpaba	28010	0.0036%	18268	0.00236%	46278
ehecnho	591	0.0001%	18228	0.00235%	18819
b-vrabtu1	4621	0.0006%	18174	0.00235%	22795
b-fii-d	3425	0.0004%	18163	0.00234%	21588
ps-strnho	5981	0.0008%	18160	0.00234%	24141
sh/eiecnho	564	0.0001%	18104	0.00234%	18668
s-mta	3153	0.0004%	18096	0.00234%	21249
ts-pad-5tu	6720	0.0009%	18085	0.00233%	24805
s-tyglab	7562	0.0010%	18040	0.00233%	25602
b-lydiff	104	0.0000%	17982	0.00232%	18086
f-kystat	2395	0.0003%	17980	0.00232%	20375
s-jo1ab	3301	0.0004%	17948	0.00232%	21249
vibrnho	568	0.0001%	17901	0.00231%	18469
plesnho	569	0.0001%	17892	0.00231%	18461
p-hcg-tot	49362	0.0064%	17890	0.00231%	67252
li-borrabm	2320	0.0003%	17827	0.00230%	20147
rakkoaika	231165	0.0298%	17798	0.00230%	248963
vb-pco2	475688	0.0614%	17730	0.00229%	493418
s-psa-t	157953	0.0204%	17668	0.00228%	175621
salmnho	586	0.0001%	17668	0.00228%	18254
s-puumabm	4432	0.0006%	17661	0.00228%	22093
u-keto	560	0.0001%	17640	0.00228%	18200
b-crp-pik	9299	0.0012%	17455	0.00225%	26754
p-tnt-lb	4281	0.0006%	17448	0.00225%	21729
s-vzvab	3719	0.0005%	17430	0.00225%	21149
u-prot-ou	3680	0.0005%	17422	0.00225%	21102
bf-syto	975	0.0001%	17399	0.00225%	18374
li-borrabg	2803	0.0004%	17377	0.00224%	20180
hb-o	11135	0.0014%	17250	0.00223%	28385
p-ca-ion.	829489	0.1070%	17100	0.00221%	846589
ts-padbrea	2315	0.0003%	17067	0.00220%	19382
pf-syto	2482	0.0003%	17045	0.00220%	19527
p-cea	87290	0.0113%	16988	0.00219%	104278
ua-hetashb	2951	0.0004%	16962	0.00219%	19913
p-tfr	347019	0.0448%	16958	0.00219%	363977
-stpnag	435	0.0001%	16644	0.00215%	17079
l-ly	769028	0.0992%	16643	0.00215%	785671
l-ly	4868	0.0006%	16643	0.00215%	21511
oma-u-tutk,u-ph	609	0.0001%	16609	0.00214%	17218
f-mm-touk	1914	0.0002%	16501	0.00213%	18415
pt-dxm-r1	334	0.0000%	16357	0.00211%	16691
p-bnp	374604	0.0483%	16268	0.00210%	390872
li-borrab	1305	0.0002%	16247	0.00210%	17552
u-alb/kre	17332	0.0022%	16058	0.00207%	33390
s-toxoabm	1951	0.0003%	16004	0.00207%	17955
pf-diffi	2521	0.0003%	15994	0.00206%	18515
s-soijape	5629	0.0007%	15917	0.00205%	21546
s-chpnabg	28108	0.0036%	15800	0.00204%	43908
u-veri-ou	5317	0.0007%	15777	0.00204%	21094
b-hlakeli	1366	0.0002%	15719	0.00203%	17085
s-pÃ¶lyer	61137	0.0079%	15699	0.00203%	76836
b-neut_	224021	0.0289%	15697	0.00203%	239718
b-neut_	4711	0.0006%	15697	0.00203%	20408
s-tygl-va	4525	0.0006%	15693	0.00203%	20218
oma-p-gluk	14566	0.0019%	15640	0.00202%	30206
vb-hb	110201	0.0142%	15637	0.00202%	125838
s-hepyaba	22024	0.0028%	15630	0.00202%	37654
s-Ã¤it-seul	172	0.0000%	15473	0.00200%	15645
-hsvnho	2942	0.0004%	15471	0.00200%	18413
b-erblas	14376	0.0019%	15437	0.00199%	29813
b-crp-poc	23953	0.0031%	15382	0.00199%	39335
u-sakka	103	0.0000%	15248	0.00197%	15351
ts-padpika	2060	0.0003%	15176	0.00196%	17236
s-toxoabg	4156	0.0005%	15141	0.00195%	19297
oma-crp-pi	1057	0.0001%	15049	0.00194%	16106
s-hevonee	21374	0.0028%	14996	0.00194%	36370
crp(pÃ¤iv.hoitaja)	1192	0.0002%	14948	0.00193%	16140
hmpvnho	197	0.0000%	14931	0.00193%	15128
ca++/7.40	220012	0.0284%	14927	0.00193%	234939
pin3nho	166	0.0000%	14916	0.00192%	15082
s-ca19-9	100398	0.0130%	14869	0.00192%	115267
s-puumabo	1084	0.0001%	14633	0.00189%	15717
cb-ca-ion	65072	0.0084%	14609	0.00189%	79681
s-ca-i7.4	190297	0.0246%	14574	0.00188%	204871
p-inr-pik	159	0.0000%	14513	0.00187%	14672
bm-pad	2173	0.0003%	14510	0.00187%	16683
b-jak2-d	1059	0.0001%	14490	0.00187%	15549
s-hsvabm	1766	0.0002%	14434	0.00186%	16200
b-morfo	1534	0.0002%	14414	0.00186%	15948
cu-alb	18680	0.0024%	14360	0.00185%	33040
pt-audio-1	258	0.0000%	14235	0.00184%	14493
b-tnt	10396	0.0013%	14195	0.00183%	24591
p-ck	1002814	0.1294%	13938	0.00180%	1016752
s-gadab	12266	0.0016%	13917	0.00180%	26183
li-baktvr	2126	0.0003%	13756	0.00178%	15882
b-crco	1389	0.0002%	13756	0.00178%	15145
s-kissae	25184	0.0033%	13742	0.00177%	38926
sk-pad-if	826	0.0001%	13721	0.00177%	14547
pt-spird-x	135	0.0000%	13659	0.00176%	13794
s-puumabg	5001	0.0006%	13625	0.00176%	18626
np-pinfrsv	2118	0.0003%	13590	0.00175%	15708
s-koirae	25545	0.0033%	13569	0.00175%	39114
s-ebvabg	29344	0.0038%	13544	0.00175%	42888
s-ebvabg	567	0.0001%	13544	0.00175%	14111
b-vasseu1	3818	0.0005%	13496	0.00174%	17314
s-ana-ty	1726	0.0002%	13484	0.00174%	15210
p-b2gpabg	9952	0.0013%	13469	0.00174%	23421
b-crp-pika	20805	0.0027%	13450	0.00174%	34255
cb-po2	244859	0.0316%	13444	0.00173%	258303
np-pikcv19	157	0.0000%	13346	0.00172%	13503
s-hcrp	14090	0.0018%	13334	0.00172%	27424
pt-spirom	2650	0.0003%	13309	0.00172%	15959
pf-solut	6351	0.0008%	13302	0.00172%	19653
cp-gluk-po	19205	0.0025%	13272	0.00171%	32477
s-bopeaba	6851	0.0009%	13242	0.00171%	20093
uv-be	3166	0.0004%	13219	0.00171%	16385
s-gbmab	494	0.0001%	13081	0.00169%	13575
tb1	529	0.0001%	13022	0.00168%	13551
tb2	554	0.0001%	12846	0.00166%	13400
u-sakka,eryt	814	0.0001%	12803	0.00165%	13617
zb-be	14606	0.0019%	12790	0.00165%	27396
b-peth	30639	0.0040%	12774	0.00165%	43413
s-vehnï¿½e	3368	0.0004%	12730	0.00164%	16098
u-huuml-o	179	0.0000%	12721	0.00164%	12900
s-maapï¿½he	4074	0.0005%	12692	0.00164%	16766
u-sakka,leuk	812	0.0001%	12607	0.00163%	13419
b-sikiÃ¶rh	1995	0.0003%	12570	0.00162%	14565
u-keto-0	10916	0.0014%	12565	0.00162%	23481
-mdrsvi	1661	0.0002%	12565	0.00162%	14226
li-igg-oc	803	0.0001%	12528	0.00162%	13331
s-hsvab	1013	0.0001%	12507	0.00161%	13520
f-crypnho	143	0.0000%	12215	0.00158%	12358
sy-unï¿½kï¿½-o	4455	0.0006%	12164	0.00157%	16619
-pin3ag	128	0.0000%	12102	0.00156%	12230
pt-lisÃ¤lau	3094	0.0004%	12066	0.00156%	15160
s-hbcabm	18336	0.0024%	11937	0.00154%	30273
s-cdt	438438	0.0566%	11872	0.00153%	450310
hoi-crp-pi	16583	0.0021%	11819	0.00153%	28402
p-crp-hy*	17488	0.0023%	11766	0.00152%	29254
b-lymf	849263	0.1096%	11595	0.00150%	860858
b-lymf	3284	0.0004%	11595	0.00150%	14879
s-havabg	2088	0.0003%	11503	0.00148%	13591
s-lkmab	2083	0.0003%	11479	0.00148%	13562
p-nest-vt	884	0.0001%	11433	0.00148%	12317
-rsvbnho	112	0.0000%	11413	0.00147%	11525
s-hcvnh	1061	0.0001%	11402	0.00147%	12463
as-syto	2230	0.0003%	11391	0.00147%	13621
u-osmest	469849	0.0606%	11383	0.00147%	481232
ts-padkolp	131	0.0000%	11354	0.00147%	11485
s-infliab	3354	0.0004%	11341	0.00146%	14695
oma-hba1c	2612	0.0003%	11338	0.00146%	13950
pt-brdil	2259	0.0003%	11317	0.00146%	13576
u-lier	1010117	0.1304%	11277	0.00146%	1021394
f-virnho	243	0.0000%	11025	0.00142%	11268
u-huseula	6273	0.0008%	10988	0.00142%	17261
u-gluk-0	35362	0.0046%	10940	0.00141%	46302
p-inr-vt	55034	0.0071%	10912	0.00141%	65946
u-pneuag	630	0.0001%	10822	0.00140%	11452
u-prot-fr	646	0.0001%	10777	0.00139%	11423
li-hsvnho	1257	0.0002%	10771	0.00139%	12028
u-baktalv	952	0.0001%	10771	0.00139%	11723
p-tt	1225925	0.1582%	10764	0.00139%	1236689
ab-het-ion	2155	0.0003%	10738	0.00139%	12893
sprv-laus	1165	0.0002%	10737	0.00139%	11902
mrsa-sevi	130	0.0000%	10692	0.00138%	10822
b-tnt-vt	1279	0.0002%	10669	0.00138%	11948
b-qr-crp	8147	0.0011%	10641	0.00137%	18788
hoicrp	10050	0.0013%	10631	0.00137%	20681
crppika	9076	0.0012%	10628	0.00137%	19704
s-pï¿½lyer	21726	0.0028%	10590	0.00137%	32316
f-hhb	1186	0.0002%	10559	0.00136%	11745
-strvi	2062	0.0003%	10534	0.00136%	12596
f-elast1	33771	0.0044%	10531	0.00136%	44302
s-parvab	1092	0.0001%	10506	0.00136%	11598
p-kardabg	14206	0.0018%	10414	0.00134%	24620
u-suht-hy	25723	0.0033%	10396	0.00134%	36119
rsvanho	150	0.0000%	10393	0.00134%	10543
u-immfix	363	0.0000%	10378	0.00134%	10741
p-aptt	461142	0.0595%	10294	0.00133%	471436
p-gluk,tk	7165	0.0009%	10292	0.00133%	17457
rsvbnho	253	0.0000%	10290	0.00133%	10543
bm-kromos	1662	0.0002%	10221	0.00132%	11883
u-nitro-0	1242	0.0002%	10170	0.00131%	11412
s-hcvnho	3452	0.0004%	10160	0.00131%	13612
ts-pad-pnb	1808	0.0002%	10138	0.00131%	11946
u-alb-0	1277	0.0002%	10138	0.00131%	11415
vb-ahco3	107002	0.0138%	10031	0.00129%	117033
p-laaptct	4717	0.0006%	9942	0.00128%	14659
oma-u-tutk,u-gluk	182	0.0000%	9886	0.00128%	10068
vb-po2	357641	0.0462%	9885	0.00128%	367526
oma-u-tutk,u-leuk	181	0.0000%	9879	0.00127%	10060
oma-u-tutk,u-nitr	179	0.0000%	9860	0.00127%	10039
oma-u-tutk,u-alb	179	0.0000%	9804	0.00127%	9983
uv-vekaas	134	0.0000%	9802	0.00126%	9936
li-vzvnho	1253	0.0002%	9799	0.00126%	11052
lr-pad	1607	0.0002%	9797	0.00126%	11404
oma-u-tutk,u-eryt	178	0.0000%	9796	0.00126%	9974
s-plab	1364	0.0002%	9795	0.00126%	11159
-dnaex	744	0.0001%	9791	0.00126%	10535
mrsaneni	104	0.0000%	9791	0.00126%	9895
mrsaperin	101	0.0000%	9789	0.00126%	9890
du-prot	57799	0.0075%	9723	0.00125%	67522
s-maapÃ¤he	17732	0.0023%	9707	0.00125%	27439
u-ph-hy	28216	0.0036%	9697	0.00125%	37913
s-klotsa	89841	0.0116%	9693	0.00125%	99534
ps-stra-ag	416	0.0001%	9622	0.00124%	10038
oma-crp-pika	1011	0.0001%	9610	0.00124%	10621
p-larvvct	4717	0.0006%	9597	0.00124%	14314
u-eryt-0	2217	0.0003%	9591	0.00124%	11808
cu-alb-mi	31593	0.0041%	9579	0.00124%	41172
u-alb/krea	11251	0.0015%	9562	0.00123%	20813
s-hevab	1386	0.0002%	9558	0.00123%	10944
s-ast	12594	0.0016%	9547	0.00123%	22141
s-paras	11303	0.0015%	9512	0.00123%	20815
ts-pad-5	3317	0.0004%	9441	0.00122%	12758
s-hsv2abg	2813	0.0004%	9424	0.00122%	12237
e-retik	471728	0.0609%	9346	0.00121%	481074
vb-hetiogl	647	0.0001%	9304	0.00120%	9951
-mrsavine	116	0.0000%	9297	0.00120%	9413
-mrsavini	124	0.0000%	9295	0.00120%	9419
s-dnaab	6714	0.0009%	9252	0.00119%	15966
s-van	93359	0.0120%	9250	0.00119%	102609
s-c-ancif	2207	0.0003%	9240	0.00119%	11447
s-leuabpr	1539	0.0002%	9223	0.00119%	10762
p-crppika	12788	0.0017%	9186	0.00119%	21974
u-mdma-o	12149	0.0016%	9182	0.00118%	21331
b-kromos	1062	0.0001%	9170	0.00118%	10232
us-tsh	121566	0.0157%	9167	0.00118%	130733
du-immfix	2409	0.0003%	9135	0.00118%	11544
u-bendict	2135	0.0003%	9105	0.00118%	11240
p-gluk-vt	16738	0.0022%	9083	0.00117%	25821
b-ghba1cp	1713	0.0002%	9050	0.00117%	10763
s-psa-v/t	62369	0.0080%	9026	0.00116%	71395
happi	271	0.0000%	9014	0.00116%	9285
u-leuk-0	17918	0.0023%	9010	0.00116%	26928
s-ruok5er	15966	0.0021%	8996	0.00116%	24962
sienvi	483	0.0001%	8987	0.00116%	9470
p-lupusak	341	0.0000%	8982	0.00116%	9323
s-leu-eo	1174	0.0002%	8937	0.00115%	10111
ts-pad-4tu	3219	0.0004%	8901	0.00115%	12120
s-parvabm	1117	0.0001%	8877	0.00115%	9994
s-b2gpabg	1033	0.0001%	8875	0.00115%	9908
s-dgpab	847	0.0001%	8832	0.00114%	9679
p-tntpika	1166	0.0002%	8780	0.00113%	9946
s-inflipa	1427	0.0002%	8770	0.00113%	10197
f-cldivit	365	0.0000%	8768	0.00113%	9133
e-fenoty	1115	0.0001%	8685	0.00112%	9800
f-adenag	413	0.0001%	8671	0.00112%	9084
fp-pi	495001	0.0639%	8650	0.00112%	503651
b-tntp	179	0.0000%	8641	0.00112%	8820
f-rotaag	441	0.0001%	8610	0.00111%	9051
igehevonen	2601	0.0003%	8595	0.00111%	11196
s-bopeabm	3312	0.0004%	8546	0.00110%	11858
s-etoh	9920	0.0013%	8545	0.00110%	18465
u-lepnag	934	0.0001%	8493	0.00110%	9427
u-leuk-bv	246301	0.0318%	8489	0.00110%	254790
u-buprect	1575	0.0002%	8468	0.00109%	10043
s-puumpik	1303	0.0002%	8453	0.00109%	9756
p-tpoab	12563	0.0016%	8450	0.00109%	21013
-hsvag	152	0.0000%	8394	0.00108%	8546
pf-unï¿½kï¿½-o	2535	0.0003%	8377	0.00108%	10912
ps-stragho	2589	0.0003%	8339	0.00108%	10928
fp-urea	328791	0.0424%	8335	0.00108%	337126
-rvirag	311	0.0000%	8328	0.00107%	8639
cb-bil	15534	0.0020%	8289	0.00107%	23823
crpvastaanotolla	5681	0.0007%	8289	0.00107%	13970
f-saponho	106	0.0000%	8279	0.00107%	8385
s-pemfiab	5204	0.0007%	8273	0.00107%	13477
vb-vklaaja	6662	0.0009%	8246	0.00106%	14908
b-ph	221293	0.0286%	8238	0.00106%	229531
s-iglcl-v	102413	0.0132%	8197	0.00106%	110610
p-omagluk	876	0.0001%	8186	0.00106%	9062
cb-ahco3	69540	0.0090%	8175	0.00105%	77715
s-chpnaba	14291	0.0018%	8149	0.00105%	22440
s-afp	58419	0.0075%	8139	0.00105%	66558
s-k/l-s-v	99147	0.0128%	8093	0.00104%	107240
b-mksyn	1073	0.0001%	8087	0.00104%	9160
p-lupusak.	4495	0.0006%	8081	0.00104%	12576
s-kelisu	1990	0.0003%	8045	0.00104%	10035
ly-t-cd4	8186	0.0011%	8044	0.00104%	16230
oma-ghb-a1c	2373	0.0003%	8026	0.00104%	10399
s-t4-v	949693	0.1226%	8008	0.00103%	957701
-pncanho	844	0.0001%	7976	0.00103%	8820
s-soijae	6801	0.0009%	7966	0.00103%	14767
s-hevabm	1372	0.0002%	7955	0.00103%	9327
b-pco2	186123	0.0240%	7928	0.00102%	194051
p-gluk-o	39903	0.0051%	7914	0.00102%	47817
s-bopeabg	8594	0.0011%	7906	0.00102%	16500
u-solu	3194	0.0004%	7904	0.00102%	11098
cb-ca-i7.4	45898	0.0059%	7890	0.00102%	53788
p-trombai	86137	0.0111%	7886	0.00102%	94023
b-po2	186351	0.0240%	7876	0.00102%	194227
s-hephiv	1010	0.0001%	7853	0.00101%	8863
s-hevabg	1499	0.0002%	7846	0.00101%	9345
-dermnho	454	0.0001%	7811	0.00101%	8265
b-dnamut	129	0.0000%	7807	0.00101%	7936
pt-lisÃ¤syt	182	0.0000%	7790	0.00101%	7972
f-enve-o	773	0.0001%	7774	0.00100%	8547
-inabrsnho	100	0.0000%	7766	0.00100%	7866
s-d-25	945906	0.1221%	7765	0.00100%	953671
s-bio	1360	0.0002%	7760	0.00100%	9120
br-pad-4	620	0.0001%	7752	0.00100%	8372
p-fidd-o	42329	0.0055%	7710	0.00099%	50039
bm-molbiol	306	0.0000%	7703	0.00099%	8009
b-hba1c,t	730	0.0001%	7672	0.00099%	8402
p-uraat	735087	0.0949%	7643	0.00099%	742730
-sienna	248	0.0000%	7637	0.00099%	7885
resvirnho	3045	0.0004%	7632	0.00098%	10677
p-ld	529175	0.0683%	7622	0.00098%	536797
np-pkorsi	270	0.0000%	7580	0.00098%	7850
s-kardabm	1630	0.0002%	7526	0.00097%	9156
s-havtot	3710	0.0005%	7520	0.00097%	11230
l-lymf	784758	0.1013%	7506	0.00097%	792264
s-rnp70-ab	244	0.0000%	7505	0.00097%	7749
b-crp	23901	0.0031%	7478	0.00097%	31379
s-p-ancif	4109	0.0005%	7406	0.00096%	11515
hba1cvieri	2724	0.0004%	7344	0.00095%	10068
igekissa	4306	0.0006%	7310	0.00094%	11616
s-anaab	2414	0.0003%	7284	0.00094%	9698
p-vuotot	680	0.0001%	7281	0.00094%	7961
u-na	32497	0.0042%	7276	0.00094%	39773
(pikacrp)	4897	0.0006%	7258	0.00094%	12155
-vzvnho	1226	0.0002%	7258	0.00094%	8484
zb-ph	19946	0.0026%	7228	0.00093%	27174
zb-hbo2sat	20472	0.0026%	7217	0.00093%	27689
zb-pco2	20023	0.0026%	7215	0.00093%	27238
zb-o2-vol%	20435	0.0026%	7207	0.00093%	27642
zb-po2	20063	0.0026%	7207	0.00093%	27270
zb-ahco3	19719	0.0025%	7199	0.00093%	26918
-virvi	124	0.0000%	7159	0.00092%	7283
inr/hoito	1847	0.0002%	7148	0.00092%	8995
cb-hco3-st	266753	0.0344%	7145	0.00092%	273898
p-psaleik	490	0.0001%	7127	0.00092%	7617
pt-konsulp	161	0.0000%	7127	0.00092%	7288
s-cenp-ab	651	0.0001%	7098	0.00092%	7749
s-kardabg	1497	0.0002%	7071	0.00091%	8568
l-neut(a)	1234313	0.1593%	7068	0.00091%	1241381
l-mono(a)	1233876	0.1592%	7068	0.00091%	1240944
oma-hb	19406	0.0025%	7061	0.00091%	26467
p-lipidit	3789	0.0005%	7056	0.00091%	10845
pt-rr-pa	443	0.0001%	7051	0.00091%	7494
ln-padsent	542	0.0001%	7000	0.00090%	7542
l-lymf(a)	1234319	0.1593%	6984	0.00090%	1241303
b-cya	62628	0.0081%	6979	0.00090%	69607
-esblvi	1112	0.0001%	6942	0.00090%	8054
s-virab	138	0.0000%	6904	0.00089%	7042
s-ssa-60	899	0.0001%	6899	0.00089%	7798
s-frtuab	846	0.0001%	6897	0.00089%	7743
pikahb	18595	0.0024%	6888	0.00089%	25483
hhpvnho	1798	0.0002%	6880	0.00089%	8678
s-asta	2042	0.0003%	6841	0.00088%	8883
ps-rsvag	477	0.0001%	6796	0.00088%	7273
u-manip	164	0.0000%	6787	0.00088%	6951
s-ihovab	1432	0.0002%	6784	0.00088%	8216
s-ihotab	1946	0.0003%	6766	0.00087%	8712
s-ssa-52	1109	0.0001%	6727	0.00087%	7836
oma-u-tutk,u-leuk-o	514	0.0001%	6697	0.00086%	7211
oma-u-tutk,u-nitr-o	510	0.0001%	6691	0.00086%	7201
oma-u-tutk,u-alb-o	445	0.0001%	6683	0.00086%	7128
s-leukabo	2527	0.0003%	6678	0.00086%	9205
p-urea	374887	0.0484%	6666	0.00086%	381553
as-diffi	1148	0.0001%	6664	0.00086%	7812
s-prlmakr	109	0.0000%	6659	0.00086%	6768
oma-u-tutk,u-gluk-o	492	0.0001%	6658	0.00086%	7150
oma-u-tutk,u-keto-o	478	0.0001%	6658	0.00086%	7136
p-hco3	438915	0.0566%	6643	0.00086%	445558
igekoira	4464	0.0006%	6642	0.00086%	11106
oma-u-tutk,u-eryt-o	498	0.0001%	6636	0.00086%	7134
s-sentbab	3265	0.0004%	6623	0.00085%	9888
s-hbvnh	1905	0.0002%	6622	0.00085%	8527
sprv-lelau	1421	0.0002%	6622	0.00085%	8043
ts-pad-ish	867	0.0001%	6587	0.00085%	7454
b-vervi2	158	0.0000%	6586	0.00085%	6744
ln-pad	1467	0.0002%	6585	0.00085%	8052
pt-spiromd	1710	0.0002%	6578	0.00085%	8288
s-vehnjae	8863	0.0011%	6565	0.00085%	15428
u-ph-o	344056	0.0444%	6564	0.00085%	350620
b-tnt-hy	1252	0.0002%	6557	0.00085%	7809
gi-pad-4	272	0.0000%	6525	0.00084%	6797
s-tbeab	959	0.0001%	6514	0.00084%	7473
s-yersab	778	0.0001%	6473	0.00084%	7251
nÃ¤ytt.otto	24359	0.0031%	6430	0.00083%	30789
b-pvk+t+r	118	0.0000%	6404	0.00083%	6522
mm-hygvi	1278	0.0002%	6393	0.00083%	7671
fs-folaat	269134	0.0347%	6381	0.00082%	275515
oma-ghb-a1	982	0.0001%	6350	0.00082%	7332
u-kemseu,ph	182	0.0000%	6317	0.00082%	6499
vb-vkperus	11583	0.0015%	6311	0.00081%	17894
igekoivu	4398	0.0006%	6306	0.00081%	10704
bl-bal-1	709	0.0001%	6306	0.00081%	7015
s-e2	32095	0.0041%	6304	0.00081%	38399
s-hcg-b-v	54298	0.0070%	6229	0.00080%	60527
b-diffim	457	0.0001%	6222	0.00080%	6679
s-ca(7.4)	338307	0.0437%	6221	0.00080%	344528
s-tbeabm	1143	0.0001%	6209	0.00080%	7352
u-stpnag	1464	0.0002%	6202	0.00080%	7666
ua-ph	44205	0.0057%	6196	0.00080%	50401
-hsvvi	766	0.0001%	6171	0.00080%	6937
s-hsv1abg	6238	0.0008%	6170	0.00080%	12408
s-pct	24082	0.0031%	6167	0.00080%	30249
f-cldivi	200	0.0000%	6147	0.00079%	6347
fp-crp	3661	0.0005%	6129	0.00079%	9790
s-ena	3032	0.0004%	6112	0.00079%	9144
s-ihoab	678	0.0001%	6094	0.00079%	6772
li-mypnabg	166	0.0000%	6090	0.00079%	6256
p-la2-mix	212	0.0000%	6086	0.00079%	6298
p-lam/m	212	0.0000%	6086	0.00079%	6298
s-rrnpabb	2349	0.0003%	6080	0.00078%	8429
s-sentabb	2349	0.0003%	6080	0.00078%	8429
s-ssbabbl	2387	0.0003%	6068	0.00078%	8455
s-rnpabbl	2352	0.0003%	6068	0.00078%	8420
s-ssaabbl	2349	0.0003%	6068	0.00078%	8417
s-jo1abbl	2349	0.0003%	6067	0.00078%	8416
p-fs-mix	236	0.0000%	6056	0.00078%	6292
p-apttm/m	236	0.0000%	6056	0.00078%	6292
s-adaliab	1746	0.0002%	6042	0.00078%	7788
cp-inr-hy	17006	0.0022%	6031	0.00078%	23037
s-hisabbl	2351	0.0003%	6023	0.00078%	8374
s-smabbl	2387	0.0003%	6022	0.00078%	8409
s-scl70bl	2387	0.0003%	6017	0.00078%	8404
-borrnho	443	0.0001%	6009	0.00078%	6452
s-tshrefl	41981	0.0054%	5994	0.00077%	47975
u-sg	12295	0.0016%	5983	0.00077%	18278
u-kivi	735	0.0001%	5954	0.00077%	6689
pt-iho-r3	758	0.0001%	5947	0.00077%	6705
s-b12-vit	336011	0.0434%	5920	0.00076%	341931
p-la1-mix	421	0.0001%	5888	0.00076%	6309
p-ck-mbm	332766	0.0429%	5877	0.00076%	338643
e-coomc3d	2537	0.0003%	5854	0.00076%	8391
s-ph(akt)	311482	0.0402%	5847	0.00075%	317329
b-vervi1	180	0.0000%	5805	0.00075%	5985
li-l/liusk	675	0.0001%	5800	0.00075%	6475
s-campab	774	0.0001%	5799	0.00075%	6573
li-l/yksit	675	0.0001%	5799	0.00075%	6474
cp-inr-vt	15510	0.0020%	5746	0.00074%	21256
s-ca(akt)	311240	0.0402%	5717	0.00074%	316957
ca-baktvi	466	0.0001%	5696	0.00074%	6162
ns-staurvi	286	0.0000%	5695	0.00073%	5981
-inbnhoho	588	0.0001%	5692	0.00073%	6280
b-hba1c/pika	2801	0.0004%	5685	0.00073%	8486
cb-hb	28969	0.0037%	5681	0.00073%	34650
p-fsl-mix	637	0.0001%	5674	0.00073%	6311
s-rarah2e	9823	0.0013%	5669	0.00073%	15492
vb-ca-ion	18591	0.0024%	5668	0.00073%	24259
as-solut	3563	0.0005%	5662	0.00073%	9225
s-chlacf	232	0.0000%	5649	0.00073%	5881
b-tb1	3396	0.0004%	5643	0.00073%	9039
b-tromb	662459	0.0855%	5641	0.00073%	668100
fp-nh4-ion	97346	0.0126%	5641	0.00073%	102987
b-tb2	3396	0.0004%	5641	0.00073%	9037
b-crp-v	9881	0.0013%	5606	0.00072%	15487
bm-aspir	143	0.0000%	5600	0.00072%	5743
s-kelila	243	0.0000%	5590	0.00072%	5833
li-vzvabg	498	0.0001%	5532	0.00071%	6030
s-cv19ab	976	0.0001%	5527	0.00071%	6503
strbvieri	230	0.0000%	5522	0.00071%	5752
b-plas-o	483	0.0001%	5472	0.00071%	5955
e-coomigg	2988	0.0004%	5414	0.00070%	8402
ts-pad-1tk	442	0.0001%	5405	0.00070%	5847
ki-pad	757	0.0001%	5395	0.00070%	6152
li-ace	4366	0.0006%	5389	0.00070%	9755
u-osmoest	106913	0.0138%	5372	0.00069%	112285
s-achr-ab	2605	0.0003%	5363	0.00069%	7968
u-nitr-o*	1949	0.0003%	5363	0.00069%	7312
-hcgbsuh	1736	0.0002%	5362	0.00069%	7098
-gcvi	537	0.0001%	5308	0.00069%	5845
p-fsl/fs	1013	0.0001%	5307	0.00068%	6320
p-fs	1012	0.0001%	5306	0.00068%	6318
-cv19nho*	7136	0.0009%	5280	0.00068%	12416
sy-eryt	19191	0.0025%	5273	0.00068%	24464
s-parvabg	5013	0.0006%	5269	0.00068%	10282
phadiatop	3591	0.0005%	5257	0.00068%	8848
b-vrabgrs	768	0.0001%	5250	0.00068%	6018
p-bkvnh	1771	0.0002%	5247	0.00068%	7018
ts-kiire	1649	0.0002%	5240	0.00068%	6889
-cmvnh	1036	0.0001%	5238	0.00068%	6274
neutrofiilit	14359	0.0019%	5234	0.00068%	19593
b-tacro	60655	0.0078%	5214	0.00067%	65869
s-aspeag	628	0.0001%	5205	0.00067%	5833
pt-obd-1	760	0.0001%	5192	0.00067%	5952
li-cxcl13	2067	0.0003%	5187	0.00067%	7254
p-hcvnho	247	0.0000%	5180	0.00067%	5427
li-evirnho	199	0.0000%	5180	0.00067%	5379
pt-vainaja	1201	0.0002%	5177	0.00067%	6378
du-ca	37156	0.0048%	5169	0.00067%	42325
s-iglck-v	105544	0.0136%	5156	0.00067%	110700
-crp-pika	4178	0.0005%	5134	0.00066%	9312
s-salmab	736	0.0001%	5133	0.00066%	5869
p-glukhoi	4997	0.0006%	5114	0.00066%	10111
s-rarah9e	3014	0.0004%	5112	0.00066%	8126
fl-clue	283	0.0000%	5074	0.00065%	5357
du-metnor	226	0.0000%	5068	0.00065%	5294
ts-her2ish	773	0.0001%	5064	0.00065%	5837
e-coombp	499	0.0001%	5050	0.00065%	5549
s-lh	60649	0.0078%	5047	0.00065%	65696
li-blastit	619	0.0001%	5046	0.00065%	5665
oma-gluk	30157	0.0039%	5045	0.00065%	35202
s-rarah3e	3494	0.0005%	5031	0.00065%	8525
-inanhoho	1270	0.0002%	5030	0.00065%	6300
b-tni-vt	2894	0.0004%	4987	0.00064%	7881
li-mononuk	818	0.0001%	4982	0.00064%	5800
s-mkomp-1	71466	0.0092%	4964	0.00064%	76430
pt-no-ex	2059	0.0003%	4961	0.00064%	7020
p-crp-oma	15999	0.0021%	4939	0.00064%	20938
b-nil	3376	0.0004%	4937	0.00064%	8313
u-hyalie	190761	0.0246%	4935	0.00064%	195696
s-rnp70ab	2443	0.0003%	4909	0.00063%	7352
s-ige	149759	0.0193%	4906	0.00063%	154665
-zoonnho	3423	0.0004%	4901	0.00063%	8324
np-pÃ¤ivinf	1098	0.0001%	4897	0.00063%	5995
s-vlseabg	9560	0.0012%	4892	0.00063%	14452
u-cannact	1093	0.0001%	4865	0.00063%	5958
e-abotark	111	0.0000%	4857	0.00063%	4968
s-igg	86682	0.0112%	4853	0.00063%	91535
u-huum-su	1658	0.0002%	4851	0.00063%	6509
s-lc1ab-o	1817	0.0002%	4847	0.00063%	6664
s-lkmab-o	1817	0.0002%	4847	0.00063%	6664
s-slaab-o	1817	0.0002%	4847	0.00063%	6664
s-pdhab-o	1817	0.0002%	4847	0.00063%	6664
b-edta-nÃ¤y	187	0.0000%	4838	0.00062%	5025
s-o4.5.12	875	0.0001%	4808	0.00062%	5683
u-lieriÃ¶t	252730	0.0326%	4805	0.00062%	257535
ns-eos	2521	0.0003%	4801	0.00062%	7322
s-sentab	2174	0.0003%	4787	0.00062%	6961
p-la1/la2	1570	0.0002%	4773	0.00062%	6343
-hsvpvi	709	0.0001%	4773	0.00062%	5482
p-la2	1575	0.0002%	4768	0.00062%	6343
__-infabnh	385	0.0000%	4744	0.00061%	5129
s-anaabbl	1331	0.0002%	4736	0.00061%	6067
pt-hepy-r	419	0.0001%	4727	0.00061%	5146
pt-sper-1	398	0.0001%	4699	0.00061%	5097
fb-leuk	551504	0.0712%	4695	0.00061%	556199
b-inrvieri	11491	0.0015%	4694	0.00061%	16185
gluk-pika	6033	0.0008%	4684	0.00060%	10717
p-ferrit	843669	0.1089%	4677	0.00060%	848346
-siennho	548	0.0001%	4677	0.00060%	5225
b-edta10ml	886	0.0001%	4661	0.00060%	5547
p-alko	755	0.0001%	4653	0.00060%	5408
s-myplcf	781	0.0001%	4635	0.00060%	5416
s-b2gpabm	260	0.0000%	4631	0.00060%	4891
s-korsol	131034	0.0169%	4615	0.00060%	135649
-vÃ¤ri	2765	0.0004%	4615	0.00060%	7380
s-om5glie	3276	0.0004%	4612	0.00060%	7888
-sameus	2763	0.0004%	4608	0.00059%	7371
-hepynho	1961	0.0003%	4600	0.00059%	6561
u-prokre	12056	0.0016%	4597	0.00059%	16653
-viskos.	2747	0.0004%	4576	0.00059%	7323
sy-muutsol	2934	0.0004%	4567	0.00059%	7501
ts-pad-bio	1251	0.0002%	4555	0.00059%	5806
p-crpos	6444	0.0008%	4547	0.00059%	10991
b-bcr-qr	393	0.0001%	4547	0.00059%	4940
oma-trop-2	583	0.0001%	4526	0.00058%	5109
b-hb,tk	3450	0.0004%	4516	0.00058%	7966
s-ruokaer	13337	0.0017%	4509	0.00058%	17846
b-nipttri	955	0.0001%	4496	0.00058%	5451
b-retind	27723	0.0036%	4488	0.00058%	32211
b-kml-qr	805	0.0001%	4474	0.00058%	5279
p-aminoh	183	0.0000%	4471	0.00058%	4654
vb-hbo2sat	225909	0.0292%	4460	0.00058%	230369
s-toxocf	663	0.0001%	4441	0.00057%	5104
b-lydiff-t	835	0.0001%	4428	0.00057%	5263
ua-pco2	45922	0.0059%	4424	0.00057%	50346
rin/entnho	121	0.0000%	4423	0.00057%	4544
s-rarah1e	3626	0.0005%	4406	0.00057%	8032
b-edtanÃ¤y	793	0.0001%	4404	0.00057%	5197
s-leuabi	745	0.0001%	4401	0.00057%	5146
c-reaktiivinenproteiini,pika,tehdÃ¤Ã¤nitse	5827	0.0008%	4398	0.00057%	10225
fp-transf	260402	0.0336%	4386	0.00057%	264788
li-spektri	332	0.0000%	4385	0.00057%	4717
pt-papahpv	7093	0.0009%	4381	0.00057%	11474
-vzvag	157	0.0000%	4363	0.00056%	4520
p-igg	156629	0.0202%	4350	0.00056%	160979
fl-leuk	140	0.0000%	4350	0.00056%	4490
ua-po2	42400	0.0055%	4291	0.00055%	46691
u-leuk-o*	3034	0.0004%	4279	0.00055%	7313
ts-pad-1tu	216	0.0000%	4271	0.00055%	4487
-riennho	195	0.0000%	4240	0.00055%	4435
s-dnanab.	2903	0.0004%	4222	0.00054%	7125
ps-straag	33134	0.0043%	4218	0.00054%	37352
s-yerp3ab	978	0.0001%	4214	0.00054%	5192
nu-albkrea	22899	0.0030%	4211	0.00054%	27110
-trfesat	64976	0.0084%	4201	0.00054%	69177
u-diffi	182	0.0000%	4191	0.00054%	4373
s-keto-o	156	0.0000%	4190	0.00054%	4346
s-prot	247579	0.0320%	4182	0.00054%	251761
hmpvag	109	0.0000%	4179	0.00054%	4288
infnho	146	0.0000%	4162	0.00054%	4308
-agglut	2441	0.0003%	4154	0.00054%	6595
li-igg-ind	12329	0.0016%	4148	0.00054%	16477
s-myosab	192	0.0000%	4137	0.00053%	4329
pt-utp-1	1645	0.0002%	4135	0.00053%	5780
fp-ca	262359	0.0339%	4130	0.00053%	266489
b-hba1cvt	35295	0.0046%	4125	0.00053%	39420
-myrkyt	541	0.0001%	4115	0.00053%	4656
s-chtrabg	2551	0.0003%	4114	0.00053%	6665
b-dpyd-d	1929	0.0002%	4087	0.00053%	6016
s-rarah8e	3965	0.0005%	4072	0.00053%	8037
s-igg4	26236	0.0034%	4071	0.00053%	30307
-diagn.	2612	0.0003%	4064	0.00052%	6676
f-diennho	250	0.0000%	4061	0.00052%	4311
vb-ca-i7.4	20262	0.0026%	4057	0.00052%	24319
l:e-abo-rh	145	0.0000%	4048	0.00052%	4193
b-hba1c/p	4171	0.0005%	4046	0.00052%	8217
ro52(ssa)	145	0.0000%	4021	0.00052%	4166
l:e-coombo	145	0.0000%	4021	0.00052%	4166
s-aspfume	5388	0.0007%	3999	0.00052%	9387
s-kalatue	130	0.0000%	3991	0.00052%	4121
s-yer9ab	1243	0.0002%	3968	0.00051%	5211
s-meoh	656	0.0001%	3964	0.00051%	4620
s-fsh	107751	0.0139%	3954	0.00051%	111705
s-ipro	622	0.0001%	3953	0.00051%	4575
s-ferrit	676314	0.0873%	3939	0.00051%	680253
fs-ace	92385	0.0119%	3934	0.00051%	96319
s-kryog	876	0.0001%	3932	0.00051%	4808
s-ige-ps	551	0.0001%	3931	0.00051%	4482
p-pct	86879	0.0112%	3925	0.00051%	90804
b-lytbifn	633	0.0001%	3917	0.00051%	4550
b-vrabtu5	1146	0.0001%	3915	0.00051%	5061
u-veri-o*	2941	0.0004%	3911	0.00050%	6852
oma-fp-glu	708	0.0001%	3902	0.00050%	4610
straag-o	732	0.0001%	3898	0.00050%	4630
s-metnef	16124	0.0021%	3894	0.00050%	20018
ps-strtunn	1620	0.0002%	3891	0.00050%	5511
cu-a1miglo	2206	0.0003%	3875	0.00050%	6081
-frtuab	869	0.0001%	3871	0.00050%	4740
-nocavi	169	0.0000%	3850	0.00050%	4019
s-ruocome	3069	0.0004%	3844	0.00050%	6913
e-plas-o	304	0.0000%	3840	0.00050%	4144
p-amylp	253776	0.0327%	3832	0.00049%	257608
-mygenho	521	0.0001%	3822	0.00049%	4343
li-neut+eo	1163	0.0002%	3816	0.00049%	4979
f-baktvi2	576	0.0001%	3815	0.00049%	4391
u-tutk-3	113	0.0000%	3793	0.00049%	3906
u-suhti-o	96843	0.0125%	3781	0.00049%	100624
s-dsgab	230	0.0000%	3779	0.00049%	4009
s-vehnÃ¤e	4233	0.0005%	3770	0.00049%	8003
s-yerp1ab	1428	0.0002%	3767	0.00049%	5195
s-testovl	53326	0.0069%	3739	0.00048%	57065
s-testo	227313	0.0293%	3734	0.00048%	231047
s-c-def	490	0.0001%	3726	0.00048%	4216
f-baktvi3	122	0.0000%	3709	0.00048%	3831
s-hhv6abm	175	0.0000%	3699	0.00048%	3874
u-ph-huu	45674	0.0059%	3692	0.00048%	49366
fp-pth	333249	0.0430%	3657	0.00047%	336906
p-crp.	11670	0.0015%	3644	0.00047%	15314
pikau-sti,u-leuk-o	845	0.0001%	3587	0.00046%	4432
pikau-sti,u-ph	861	0.0001%	3585	0.00046%	4446
p-crp-p	6519	0.0008%	3584	0.00046%	10103
s-infacf	1655	0.0002%	3584	0.00046%	5239
pikau-sti,u-prot-o	859	0.0001%	3584	0.00046%	4443
pikau-sti,u-eryt-o	866	0.0001%	3583	0.00046%	4449
as-unï¿½kï¿½-o	1168	0.0002%	3581	0.00046%	4749
pikau-sti,u-nitr-o	857	0.0001%	3580	0.00046%	4437
pikau-sti,u-keto-o	870	0.0001%	3579	0.00046%	4449
pikau-sti,u-gluk-o	870	0.0001%	3578	0.00046%	4448
candvi	177	0.0000%	3575	0.00046%	3752
s-kem	263	0.0000%	3570	0.00046%	3833
p-fibr	92407	0.0119%	3552	0.00046%	95959
p-iga	161135	0.0208%	3532	0.00046%	164667
s-yer3ab	1699	0.0002%	3520	0.00045%	5219
s-igg2	15636	0.0020%	3500	0.00045%	19136
s-vzvabg	22513	0.0029%	3489	0.00045%	26002
s-vzvabg	302	0.0000%	3489	0.00045%	3791
cp-gluk-lb	153180	0.0198%	3485	0.00045%	156665
s-iga	194571	0.0251%	3478	0.00045%	198049
s-sindab	389	0.0001%	3435	0.00044%	3824
s-igg3	15709	0.0020%	3431	0.00044%	19140
b-frax-d	373	0.0000%	3427	0.00044%	3800
p-ca19-9	51941	0.0067%	3422	0.00044%	55363
li-leuk	54425	0.0070%	3421	0.00044%	57846
s-puumavi	1681	0.0002%	3405	0.00044%	5086
li-hsv1abg	119	0.0000%	3401	0.00044%	3520
b-ldlre-d	317	0.0000%	3395	0.00044%	3712
u-a1miglo	976	0.0001%	3388	0.00044%	4364
down-riski	186	0.0000%	3374	0.00044%	3560
p-inr-o	874	0.0001%	3368	0.00043%	4242
t18-riski	186	0.0000%	3341	0.00043%	3527
-covid-19-koronavirustauti,nukleiinihappo(kval)	1477	0.0002%	3339	0.00043%	4816
ts-pad-3tu	558	0.0001%	3315	0.00043%	3873
p-crp-poc	6595	0.0009%	3309	0.00043%	9904
s-nglym5e	2276	0.0003%	3308	0.00043%	5584
p-crp-hoi	8769	0.0011%	3307	0.00043%	12076
pl-pad	804	0.0001%	3303	0.00043%	4107
af-baktvi	694	0.0001%	3299	0.00043%	3993
li-tbeabm	342	0.0000%	3288	0.00042%	3630
s-tsh	1346015	0.1737%	3286	0.00042%	1349301
s-hbvnho	210	0.0000%	3285	0.00042%	3495
pt-audio	646	0.0001%	3252	0.00042%	3898
s-tbetot	862	0.0001%	3242	0.00042%	4104
u-keto-o*	1716	0.0002%	3217	0.00042%	4933
virtsanliuskatutkimukset	128	0.0000%	3215	0.00041%	3343
s-nglym6e	2347	0.0003%	3213	0.00041%	5560
sy-leuk	45925	0.0059%	3196	0.00041%	49121
b-tpmt-d	217	0.0000%	3194	0.00041%	3411
s-ifx-ab	265	0.0000%	3191	0.00041%	3456
rvirag-o	1208	0.0002%	3185	0.00041%	4393
s-dsg1ab	680	0.0001%	3183	0.00041%	3863
s-w-h:a	752	0.0001%	3172	0.00041%	3924
s-ovomuke	7935	0.0010%	3158	0.00041%	11093
p-inr-hy	25401	0.0033%	3150	0.00041%	28551
s-campabg	3044	0.0004%	3133	0.00040%	6177
p-citratm	324	0.0000%	3132	0.00040%	3456
s-asca	265	0.0000%	3117	0.00040%	3382
b-hlabd	414	0.0001%	3105	0.00040%	3519
du-iglcl	3055	0.0004%	3100	0.00040%	6155
fl-clue-o	2367	0.0003%	3092	0.00040%	5459
p-k-vt	14903	0.0019%	3087	0.00040%	17990
s-ca-albk	22837	0.0029%	3086	0.00040%	25923
p-t3-v	171558	0.0221%	3065	0.00040%	174623
s-tsh-abr	9368	0.0012%	3063	0.00040%	12431
s-dsg3ab	811	0.0001%	3055	0.00039%	3866
s-cv19abg	563	0.0001%	3053	0.00039%	3616
ntkmom	39775	0.0051%	3043	0.00039%	42818
pappakmom	39777	0.0051%	3041	0.00039%	42818
fs-kol	1140830	0.1472%	3038	0.00039%	1143868
s-hsvabg	1836	0.0002%	3032	0.00039%	4868
s-rglym4e	1861	0.0002%	3030	0.00039%	4891
s-dmklots	54185	0.0070%	3025	0.00039%	57210
-palovvi	1261	0.0002%	3008	0.00039%	4269
s-leuabii	543	0.0001%	3001	0.00039%	3544
s-sindabm	461	0.0001%	2993	0.00039%	3454
li-gluk	48255	0.0062%	2992	0.00039%	51247
e-erytbla	22018	0.0028%	2986	0.00039%	25004
s-b12-akt	31456	0.0041%	2982	0.00038%	34438
pf-eryt	17256	0.0022%	2970	0.00038%	20226
s-igg1	16275	0.0021%	2970	0.00038%	19245
s-tr2seul	608	0.0001%	2969	0.00038%	3577
hcgbvkmom	39180	0.0051%	2968	0.00038%	42148
s-mtx	17421	0.0022%	2955	0.00038%	20376
ts-padgas2	1460	0.0002%	2949	0.00038%	4409
bm-fish	472	0.0001%	2948	0.00038%	3420
s-ebvabmo	770	0.0001%	2943	0.00038%	3713
-aspeag	365	0.0000%	2932	0.00038%	3297
s-campaba	2949	0.0004%	2929	0.00038%	5878
uv-ph	13558	0.0017%	2914	0.00038%	16472
u-huume-o	5377	0.0007%	2912	0.00038%	8289
s-langab	1854	0.0002%	2892	0.00037%	4746
u-ominp-h	43000	0.0055%	2888	0.00037%	45888
cb-hetiong	2200	0.0003%	2884	0.00037%	5084
b-tbevi	146	0.0000%	2880	0.00037%	3026
s-enal	732	0.0001%	2873	0.00037%	3605
s-pla2rab	1545	0.0002%	2872	0.00037%	4417
b-hlaad	407	0.0001%	2866	0.00037%	3273
p-cl	978995	0.1263%	2865	0.00037%	981860
s-t3-v	70333	0.0091%	2859	0.00037%	73192
p-tnt-hy	587	0.0001%	2854	0.00037%	3441
du-iglck	3345	0.0004%	2849	0.00037%	6194
s-igg-sum	2315	0.0003%	2847	0.00037%	5162
cp-crp-lb	7038	0.0009%	2841	0.00037%	9879
b-sekvy-d	939	0.0001%	2839	0.00037%	3778
pika-hba1c	426	0.0001%	2839	0.00037%	3265
sk-sien-vi	148	0.0000%	2810	0.00036%	2958
s-ruoat	2321	0.0003%	2805	0.00036%	5126
s-w-h:g.m	1161	0.0001%	2772	0.00036%	3933
li-syto	279	0.0000%	2771	0.00036%	3050
u-leuk-o.	228	0.0000%	2763	0.00036%	2991
u-keto-o.	229	0.0000%	2762	0.00036%	2991
s-strdnab	1443	0.0002%	2761	0.00036%	4204
u-prot-o.	230	0.0000%	2761	0.00036%	2991
u-gluk-o.	229	0.0000%	2761	0.00036%	2990
bup	351	0.0000%	2758	0.00036%	3109
li-tbeab	339	0.0000%	2753	0.00036%	3092
-pocabrc	6811	0.0009%	2744	0.00035%	9555
p-myogl	105575	0.0136%	2742	0.00035%	108317
s-w-o6.7	968	0.0001%	2737	0.00035%	3705
cladosp.he	425	0.0001%	2736	0.00035%	3161
b-cr	12687	0.0016%	2733	0.00035%	15420
s-aitma	1481	0.0002%	2733	0.00035%	4214
s-pujospe	9324	0.0012%	2732	0.00035%	12056
s-mikrobx	655	0.0001%	2719	0.00035%	3374
p-tnthoi	223	0.0000%	2719	0.00035%	2942
s-sindabg	745	0.0001%	2715	0.00035%	3460
u-epi	122598	0.0158%	2709	0.00035%	125307
b-hladrbd	391	0.0001%	2709	0.00035%	3100
s-hcvnhty	1044	0.0001%	2704	0.00035%	3748
s-haptog	34745	0.0045%	2703	0.00035%	37448
vb-o2-sis	75826	0.0098%	2700	0.00035%	78526
p-progly	2775	0.0004%	2696	0.00035%	5471
p-meoh	2834	0.0004%	2685	0.00035%	5519
fs-trigly	1175915	0.1518%	2682	0.00035%	1178597
s-w-h:d	1235	0.0002%	2679	0.00035%	3914
sy-mononuk	5557	0.0007%	2669	0.00034%	8226
s-maksaab	178	0.0000%	2666	0.00034%	2844
p-monab-o	573	0.0001%	2659	0.00034%	3232
oma-b-hb	4764	0.0006%	2656	0.00034%	7420
s-infli	8505	0.0011%	2653	0.00034%	11158
s-evircf	2586	0.0003%	2646	0.00034%	5232
b-thb	58211	0.0075%	2640	0.00034%	60851
glukoosi(pÃ¤iv.hoitaja)	224	0.0000%	2632	0.00034%	2856
fp-laktaat	463022	0.0598%	2629	0.00034%	465651
p-acth	25721	0.0033%	2603	0.00034%	28324
s-adencf	2615	0.0003%	2591	0.00033%	5206
l-mono	305871	0.0395%	2590	0.00033%	308461
s-mito-ab	159	0.0000%	2589	0.00033%	2748
vb-hb-co	191222	0.0247%	2583	0.00033%	193805
p-etgly	2943	0.0004%	2581	0.00033%	5524
fp-fe	277733	0.0358%	2577	0.00033%	280310
s-enaabla	2047	0.0003%	2574	0.00033%	4621
fl-tric-na	239	0.0000%	2572	0.00033%	2811
p-ipro	2945	0.0004%	2568	0.00033%	5513
s-spnabvt	178	0.0000%	2567	0.00033%	2745
p-korsol	107166	0.0138%	2547	0.00033%	109713
s-htlvab	203	0.0000%	2546	0.00033%	2749
hba1cpika	1559	0.0002%	2534	0.00033%	4093
psa-v/psa	107626	0.0139%	2527	0.00033%	110153
mrsavi	111	0.0000%	2515	0.00032%	2626
p-khoi	1093	0.0001%	2513	0.00032%	3606
kol/hdlsuh	317004	0.0409%	2506	0.00032%	319510
s-kyhemag	980	0.0001%	2498	0.00032%	3478
cb-leuk-hy	5334	0.0007%	2490	0.00032%	7824
strepa	1870	0.0002%	2479	0.00032%	4349
s-etgly	654	0.0001%	2478	0.00032%	3132
p-kardabm	1916	0.0002%	2476	0.00032%	4392
-infrsvnho	796	0.0001%	2470	0.00032%	3266
enrirsvnho	273	0.0000%	2467	0.00032%	2740
p-tnih	12665	0.0016%	2460	0.00032%	15125
-toxonho	153	0.0000%	2459	0.00032%	2612
-sytokiir	116	0.0000%	2458	0.00032%	2574
s-campabm	3022	0.0004%	2457	0.00032%	5479
cp-gluk	52785	0.0068%	2455	0.00032%	55240
s-hbeag	310	0.0000%	2448	0.00032%	2758
s-mkomp-2	68768	0.0089%	2442	0.00032%	71210
-askirje	1240	0.0002%	2433	0.00031%	3673
s-cmvavi	5517	0.0007%	2432	0.00031%	7949
u-lieriÃ¶	43613	0.0056%	2423	0.00031%	46036
s-w-h:i	1508	0.0002%	2421	0.00031%	3929
p-asetoni	1903	0.0002%	2413	0.00031%	4316
i-stathb	587	0.0001%	2412	0.00031%	2999
i-statk	580	0.0001%	2412	0.00031%	2992
i-statna	588	0.0001%	2408	0.00031%	2996
s-histab	129	0.0000%	2405	0.00031%	2534
bm-resid	291	0.0000%	2401	0.00031%	2692
pt-eneg-1	170	0.0000%	2400	0.00031%	2570
-psa-v/t	1258	0.0002%	2399	0.00031%	3657
ihopisto	3596	0.0005%	2396	0.00031%	5992
s-okarba	676	0.0001%	2393	0.00031%	3069
fl-trihina	2524	0.0003%	2392	0.00031%	4916
-ebvnh	428	0.0001%	2376	0.00031%	2804
b-trfupfa	293	0.0000%	2374	0.00031%	2667
s-infbcf	2806	0.0004%	2366	0.00031%	5172
vb-hb-met	181951	0.0235%	2365	0.00031%	184316
s-vlseabm	12081	0.0016%	2357	0.00030%	14438
he-pad	405	0.0001%	2354	0.00030%	2759
li-hhv6nh	507	0.0001%	2349	0.00030%	2856
uv-hetashb	399	0.0001%	2345	0.00030%	2744
ts-hnpccih	1071	0.0001%	2343	0.00030%	3414
i-statcrea	1503	0.0002%	2338	0.00030%	3841
s-c-pept	7262	0.0009%	2333	0.00030%	9595
p-igm	86671	0.0112%	2331	0.00030%	89002
hevonen	1735	0.0002%	2322	0.00030%	4057
u-amfetct	560	0.0001%	2321	0.00030%	2881
s-pÃ¤hcome	1544	0.0002%	2317	0.00030%	3861
s-w-o9.12	1229	0.0002%	2309	0.00030%	3538
s-mkomp-3	58364	0.0075%	2306	0.00030%	60670
s-toxoavi	2005	0.0003%	2304	0.00030%	4309
i-stathct	687	0.0001%	2302	0.00030%	2989
povnh	334	0.0000%	2299	0.00030%	2633
l-prom-m	5731	0.0007%	2289	0.00030%	8020
b-extem	249	0.0000%	2283	0.00029%	2532
b-fibtem	249	0.0000%	2282	0.00029%	2531
s-gt-cdt	21152	0.0027%	2281	0.00029%	23433
s-inhibb	5372	0.0007%	2280	0.00029%	7652
b-ti	993	0.0001%	2275	0.00029%	3268
p-psasÃ¤de	5055	0.0007%	2266	0.00029%	7321
vb-thb	162211	0.0209%	2261	0.00029%	164472
u-hcgo-lb	422	0.0001%	2261	0.00029%	2683
b-hhv6nh	1369	0.0002%	2257	0.00029%	3626
s-mkomp-4	58220	0.0075%	2255	0.00029%	60475
s-dnan-ab	719	0.0001%	2253	0.00029%	2972
p-fii	4292	0.0006%	2245	0.00029%	6537
-cand-vi	270	0.0000%	2243	0.00029%	2513
s-toxoaba	1674	0.0002%	2235	0.00029%	3909
s-igm	51649	0.0067%	2232	0.00029%	53881
s-nmdarab	113	0.0000%	2226	0.00029%	2339
s-vedolpa	687	0.0001%	2223	0.00029%	2910
b-bio	438	0.0001%	2223	0.00029%	2661
s-pakkas	336	0.0000%	2218	0.00029%	2554
pujo	1921	0.0002%	2217	0.00029%	4138
jo-1	214	0.0000%	2217	0.00029%	2431
d.pteronys	1603	0.0002%	2215	0.00029%	3818
u-levyepi	18114	0.0023%	2213	0.00029%	20327
s-ca12-5	102112	0.0132%	2211	0.00029%	104323
p-tnt-poc	157	0.0000%	2204	0.00028%	2361
p-inr-oma	1145	0.0001%	2201	0.00028%	3346
p-glukpoc	1400	0.0002%	2200	0.00028%	3600
p-lakthoi	944	0.0001%	2199	0.00028%	3143
s-hcg-tot	1274	0.0002%	2192	0.00028%	3466
p-fx	4347	0.0006%	2185	0.00028%	6532
s-morbab	532	0.0001%	2184	0.00028%	2716
s-gt	812044	0.1048%	2180	0.00028%	814224
b-tnt-oho	324	0.0000%	2177	0.00028%	2501
p-kysc	116919	0.0151%	2168	0.00028%	119087
l-baso-m	23768	0.0031%	2164	0.00028%	25932
l-baso-m	206	0.0000%	2164	0.00028%	2370
s-hbeab	331	0.0000%	2159	0.00028%	2490
du-na	8066	0.0010%	2155	0.00028%	10221
s-aqp4ab	432	0.0001%	2153	0.00028%	2585
sy-neut+eo	3194	0.0004%	2150	0.00028%	5344
-nt	37406	0.0048%	2147	0.00028%	39553
fs-gh	17446	0.0023%	2144	0.00028%	19590
p-pthrp	362	0.0000%	2144	0.00028%	2506
bm-aso2-qd	141	0.0000%	2130	0.00027%	2271
s-tob	4775	0.0006%	2123	0.00027%	6898
fl-candvi	991	0.0001%	2118	0.00027%	3109
s-amh	26764	0.0035%	2115	0.00027%	28879
s-vedolab	820	0.0001%	2111	0.00027%	2931
s-rsvcf	3101	0.0004%	2100	0.00027%	5201
s-seerumn	162	0.0000%	2099	0.00027%	2261
p-fxi	1723	0.0002%	2096	0.00027%	3819
vitascreen	2677	0.0003%	2094	0.00027%	4771
sy-gran	6202	0.0008%	2090	0.00027%	8292
p-fxii	1703	0.0002%	2088	0.00027%	3791
-crppika	2518	0.0003%	2087	0.00027%	4605
li-prot	58098	0.0075%	2085	0.00027%	60183
b-temp	26504	0.0034%	2085	0.00027%	28589
s-pr3abg	194	0.0000%	2084	0.00027%	2278
s-alfa-2	66021	0.0085%	2075	0.00027%	68096
b-hb-ief	426	0.0001%	2068	0.00027%	2494
ab-hb-met	580955	0.0750%	2066	0.00027%	583021
pt-pef	3370	0.0004%	2062	0.00027%	5432
li-hsvabg	464	0.0001%	2049	0.00026%	2513
fs-kol-ldl	1136346	0.1466%	2048	0.00026%	1138394
fp-krea	2084164	0.2690%	2042	0.00026%	2086206
ts-hepyvi	818	0.0001%	2037	0.00026%	2855
s-alfa-1	66166	0.0085%	2033	0.00026%	68199
s-w-h:b	1902	0.0002%	2028	0.00026%	3930
konsultaatiopyyntÃ¶erikoislÃ¤Ã¤kÃ¤rille	111	0.0000%	2026	0.00026%	2137
li-tpha	197	0.0000%	2025	0.00026%	2222
s-pï¿½lyry	3002	0.0004%	2019	0.00026%	5021
lu-pad	798	0.0001%	2019	0.00026%	2817
s-koivspe	11601	0.0015%	2011	0.00026%	13612
s-timospe	11007	0.0014%	2009	0.00026%	13016
b-tni-v	237	0.0000%	2008	0.00026%	2245
s-morbabg	1653	0.0002%	2006	0.00026%	3659
p-fviii.	71131	0.0092%	2003	0.00026%	73134
s-tfr	287452	0.0371%	2000	0.00026%	289452
l-blast-m	7285	0.0009%	1975	0.00025%	9260
p-inr-poc	2092	0.0003%	1973	0.00025%	4065
s-anaab-a	525	0.0001%	1972	0.00025%	2497
b-hb-fr	419	0.0001%	1964	0.00025%	2383
ap-na	278996	0.0360%	1960	0.00025%	280956
ts-hemafc	187	0.0000%	1935	0.00025%	2122
s-tbeabg	1131	0.0001%	1927	0.00025%	3058
fs-fe	127102	0.0164%	1920	0.00025%	129022
pf-eos	5306	0.0007%	1911	0.00025%	7217
happisaturaatiovastaanotolla	114	0.0000%	1907	0.00025%	2021
ca++ph7.4	154903	0.0200%	1902	0.00025%	156805
b-liuskat	166367	0.0215%	1901	0.00025%	168268
ab-hb-co	568753	0.0734%	1891	0.00024%	570644
ex-eos	569	0.0001%	1890	0.00024%	2459
ab-hco3	93855	0.0121%	1875	0.00024%	95730
p-hcvnh	1049	0.0001%	1873	0.00024%	2922
vp-k	51045	0.0066%	1872	0.00024%	52917
s-pÃ¶lyt	2534	0.0003%	1871	0.00024%	4405
s-beta-2	65498	0.0085%	1869	0.00024%	67367
s-seerumi	243	0.0000%	1868	0.00024%	2111
fs-transf	91848	0.0119%	1866	0.00024%	93714
s-valpr	105031	0.0136%	1860	0.00024%	106891
pf-ada	11579	0.0015%	1860	0.00024%	13439
vp-laktaat	50827	0.0066%	1859	0.00024%	52686
b-erytbl	7653	0.0010%	1859	0.00024%	9512
vp-na	51062	0.0066%	1856	0.00024%	52918
lipidit	5877	0.0008%	1850	0.00024%	7727
b-cd34-fc	782	0.0001%	1850	0.00024%	2632
b-hco3	44227	0.0057%	1847	0.00024%	46074
s-beta-1	65587	0.0085%	1844	0.00024%	67431
vp-gluk	50825	0.0066%	1843	0.00024%	52668
vp-ca-ion	50293	0.0065%	1836	0.00024%	52129
s-hhv6ab	135	0.0000%	1836	0.00024%	1971
vp-cl	50833	0.0066%	1832	0.00024%	52665
s-hae	393	0.0001%	1829	0.00024%	2222
s-nproh	539	0.0001%	1827	0.00024%	2366
cb-inrpika	2256	0.0003%	1824	0.00024%	4080
f-virag	277	0.0000%	1821	0.00024%	2098
s-rcora8e	2683	0.0003%	1820	0.00023%	4503
cb-laktaat	48761	0.0063%	1819	0.00023%	50580
p-kol-ldl	249612	0.0322%	1811	0.00023%	251423
s-morbabm	429	0.0001%	1803	0.00023%	2232
pf-prot	24277	0.0031%	1801	0.00023%	26078
koira,hils	2083	0.0003%	1797	0.00023%	3880
f-diennho*	356	0.0000%	1795	0.00023%	2151
s-album	60512	0.0078%	1793	0.00023%	62305
fs-trfesat	54435	0.0070%	1786	0.00023%	56221
u-ket-o	1607	0.0002%	1785	0.00023%	3392
s-ohkarba	21038	0.0027%	1784	0.00023%	22822
as-eryt	7295	0.0009%	1778	0.00023%	9073
s-ranao3e	6668	0.0009%	1778	0.00023%	8446
cb-to2c	47294	0.0061%	1776	0.00023%	49070
pulssi	11067	0.0014%	1776	0.00023%	12843
li-hhv6abg	132	0.0000%	1775	0.00023%	1907
s-jcvab	737	0.0001%	1773	0.00023%	2510
nÃ¤ytekulje	179	0.0000%	1770	0.00023%	1949
s-rjugr1e	6125	0.0008%	1769	0.00023%	7894
pf-kol	2319	0.0003%	1767	0.00023%	4086
l-liuskat	185078	0.0239%	1757	0.00023%	186835
s-adrab	382	0.0000%	1757	0.00023%	2139
l-sauvat	17096	0.0022%	1751	0.00023%	18847
ap-laktaat	283033	0.0365%	1750	0.00023%	284783
s-hs-crp	18281	0.0024%	1745	0.00023%	20026
b-tnt-o-pika	140	0.0000%	1735	0.00022%	1875
p-pbnp-lb	19895	0.0026%	1734	0.00022%	21629
u-kÃ¤sma	117	0.0000%	1733	0.00022%	1850
kissa	2442	0.0003%	1732	0.00022%	4174
s-asetoni	711	0.0001%	1731	0.00022%	2442
du-k	6376	0.0008%	1730	0.00022%	8106
u-orgah	121	0.0000%	1729	0.00022%	1850
f-hb-o2	439	0.0001%	1725	0.00022%	2164
pt-gfreepio1	5351	0.0007%	1722	0.00022%	7073
ap-k	279275	0.0360%	1720	0.00022%	280995
b-hb-a1c	292638	0.0378%	1718	0.00022%	294356
l-meta-m	9318	0.0012%	1717	0.00022%	11035
pf-muutsol	1484	0.0002%	1713	0.00022%	3197
s-aldol	10507	0.0014%	1699	0.00022%	12206
s-yersaba	503	0.0001%	1697	0.00022%	2200
pt-gluk-r2	251	0.0000%	1696	0.00022%	1947
b-gluk	6933	0.0009%	1692	0.00022%	8625
sy-lymf	2630	0.0003%	1691	0.00022%	4321
s-lipidit	451	0.0001%	1690	0.00022%	2141
s-li	67268	0.0087%	1687	0.00022%	68955
s-testo-vl	4033	0.0005%	1684	0.00022%	5717
koivu	2920	0.0004%	1682	0.00022%	4602
s-hbe	244	0.0000%	1672	0.00022%	1916
cb-o2hb	45399	0.0059%	1670	0.00022%	47069
s-prl	107550	0.0139%	1660	0.00021%	109210
s-goodpk	961	0.0001%	1656	0.00021%	2617
pf-gluk	15929	0.0021%	1654	0.00021%	17583
b-laktaat	2022	0.0003%	1648	0.00021%	3670
s-golimab	227	0.0000%	1632	0.00021%	1859
b-pb	2083	0.0003%	1629	0.00021%	3712
p-ohbutyr	4660	0.0006%	1627	0.00021%	6287
ts-pad-0	846	0.0001%	1624	0.00021%	2470
am-trinho	353	0.0000%	1621	0.00021%	1974
fl-flagnat	482	0.0001%	1619	0.00021%	2101
cb-hbo2sat	105313	0.0136%	1613	0.00021%	106926
s-rjugr3e	1647	0.0002%	1612	0.00021%	3259
s-ia2ab	1524	0.0002%	1607	0.00021%	3131
s-dengabm	116	0.0000%	1606	0.00021%	1722
li-sameus	665	0.0001%	1605	0.00021%	2270
ab-het-oks	538	0.0001%	1596	0.00021%	2134
trim	122	0.0000%	1596	0.00021%	1718
non-hdl	54914	0.0071%	1595	0.00021%	56509
ab-thb	257729	0.0333%	1591	0.00021%	259320
s-hepbc	128	0.0000%	1590	0.00021%	1718
s-rbere1e	4554	0.0006%	1589	0.00021%	6143
s-ebnaab	1227	0.0002%	1587	0.00020%	2814
s-leu-es	289	0.0000%	1577	0.00020%	1866
s-chtrabm	109	0.0000%	1573	0.00020%	1682
du-urea	2222	0.0003%	1568	0.00020%	3790
b-rotem	213	0.0000%	1562	0.00020%	1775
s-gangab	156	0.0000%	1562	0.00020%	1718
s-estdiol	4905	0.0006%	1561	0.00020%	6466
s-chlaab	108	0.0000%	1560	0.00020%	1668
s-hepabc	179	0.0000%	1550	0.00020%	1729
-pikacrp	849	0.0001%	1547	0.00020%	2396
p-b2gpabm	222	0.0000%	1547	0.00020%	1769
pf-cea	2495	0.0003%	1544	0.00020%	4039
s-sappih	24682	0.0032%	1542	0.00020%	26224
s-muskab	388	0.0001%	1542	0.00020%	1930
s-cora14e	7309	0.0009%	1541	0.00020%	8850
b-eos%	125584	0.0162%	1535	0.00020%	127119
l-myel-m	10486	0.0014%	1531	0.00020%	12017
crp(hoitaja)	3750	0.0005%	1528	0.00020%	5278
s-kkab	431	0.0001%	1524	0.00020%	1955
s-ascabg	538	0.0001%	1513	0.00020%	2051
s-lzm	67597	0.0087%	1508	0.00019%	69105
s-alb	64611	0.0083%	1503	0.00019%	66114
s-kaurae	1355	0.0002%	1502	0.00019%	2857
li-infaabg	206	0.0000%	1499	0.00019%	1705
timotei	2740	0.0004%	1496	0.00019%	4236
fs-sappih	22152	0.0029%	1495	0.00019%	23647
b-cya-ms	66196	0.0085%	1494	0.00019%	67690
s-psolab	501	0.0001%	1494	0.00019%	1995
b-baso%	59775	0.0077%	1481	0.00019%	61256
pt-gfrekys	11735	0.0015%	1481	0.00019%	13216
li-igg	15011	0.0019%	1480	0.00019%	16491
b-t-cd4	21615	0.0028%	1476	0.00019%	23091
p-k-veka	61255	0.0079%	1475	0.00019%	62730
b-intem	256	0.0000%	1472	0.00019%	1728
u-ni	6956	0.0009%	1470	0.00019%	8426
li-gran	809	0.0001%	1470	0.00019%	2279
s-pincf	3730	0.0005%	1469	0.00019%	5199
s-ascaba	582	0.0001%	1468	0.00019%	2050
p-hcg*	2038	0.0003%	1467	0.00019%	3505
pf-leuk	22430	0.0029%	1466	0.00019%	23896
p-na-veka	61251	0.0079%	1463	0.00019%	62714
glukvieri	6329	0.0008%	1463	0.00019%	7792
sy-prot	2786	0.0004%	1458	0.00019%	4244
l-neut%	158855	0.0205%	1455	0.00019%	160310
sy-neut	8394	0.0011%	1455	0.00019%	9849
ns-neut	878	0.0001%	1455	0.00019%	2333
cb-hco3	115687	0.0149%	1454	0.00019%	117141
li-eryt	57814	0.0075%	1453	0.00019%	59267
b-mono%	46548	0.0060%	1453	0.00019%	48001
hoiglukstx	2353	0.0003%	1452	0.00019%	3805
s-digoks	75556	0.0098%	1447	0.00019%	77003
oma-tnt	195	0.0000%	1440	0.00019%	1635
li-eryt-1	183	0.0000%	1438	0.00019%	1621
u-alb/kre,u-alb/krea	2571	0.0003%	1433	0.00018%	4004
fp-trfesat	171985	0.0222%	1432	0.00018%	173417
s-yersabg	773	0.0001%	1430	0.00018%	2203
u-cr	2939	0.0004%	1426	0.00018%	4365
ca++	155480	0.0201%	1423	0.00018%	156903
vt-hivagab	188	0.0000%	1420	0.00018%	1608
ts-mksyn	296	0.0000%	1419	0.00018%	1715
fl-gyn-hoi	312	0.0000%	1417	0.00018%	1729
s-propgly	545	0.0001%	1416	0.00018%	1961
vb-hetiong	1360	0.0002%	1410	0.00018%	2770
b-heptem	216	0.0000%	1410	0.00018%	1626
pf-mononuk	2857	0.0004%	1405	0.00018%	4262
s-dengabg	337	0.0000%	1403	0.00018%	1740
s-cora9e	7165	0.0009%	1401	0.00018%	8566
vb-be-vt	1245	0.0002%	1401	0.00018%	2646
l-eos-m	25101	0.0032%	1400	0.00018%	26501
l-eos-m	229	0.0000%	1400	0.00018%	1629
s-amyl-is	131	0.0000%	1399	0.00018%	1530
u-huumoct	2747	0.0004%	1395	0.00018%	4142
pf-trigly	1832	0.0002%	1392	0.00018%	3224
s-legiab	140	0.0000%	1391	0.00018%	1531
as-muutsol	793	0.0001%	1389	0.00018%	2182
s-chtrab	171	0.0000%	1384	0.00018%	1555
-listvi	264	0.0000%	1383	0.00018%	1647
li-ada	335	0.0000%	1382	0.00018%	1717
l-lymf%	154529	0.0199%	1381	0.00018%	155910
lisÃ¤tutkim	446	0.0001%	1380	0.00018%	1826
f-transfo	623	0.0001%	1379	0.00018%	2002
vt-hcvab	233	0.0000%	1378	0.00018%	1611
u-povnh	453	0.0001%	1376	0.00018%	1829
li-bam42	6186	0.0008%	1374	0.00018%	7560
albumiini	14327	0.0018%	1373	0.00018%	15700
ap-gluk	21755	0.0028%	1370	0.00018%	23125
b-gluk(vo.hoitaja)	315	0.0000%	1370	0.00018%	1685
b-leuc-v	3952	0.0005%	1363	0.00018%	5315
p-nkÃ¤s10	102	0.0000%	1363	0.00018%	1465
pt-obd-his	821	0.0001%	1360	0.00018%	2181
u-veri-0	480	0.0001%	1357	0.00018%	1837
f-hb-o3	348	0.0000%	1355	0.00017%	1703
ab-o2-sis	7142	0.0009%	1354	0.00017%	8496
u-phv	2813	0.0004%	1353	0.00017%	4166
s-gamma	69894	0.0090%	1352	0.00017%	71246
pf-ph	9473	0.0012%	1351	0.00017%	10824
li-fostau	6064	0.0008%	1349	0.00017%	7413
s-p-ancab	159	0.0000%	1349	0.00017%	1508
s-ca15-3	53327	0.0069%	1346	0.00017%	54673
b-diffi*	655	0.0001%	1346	0.00017%	2001
u-leuko-o	495	0.0001%	1343	0.00017%	1838
b-hbhplc	382	0.0000%	1340	0.00017%	1722
s-pakast5	265	0.0000%	1340	0.00017%	1605
ts-cc	809	0.0001%	1338	0.00017%	2147
b-hfe-d	339	0.0000%	1336	0.00017%	1675
p-kol-hdl	185944	0.0240%	1335	0.00017%	187279
pt-iho-r1	2563	0.0003%	1334	0.00017%	3897
s-ruise	1458	0.0002%	1334	0.00017%	2792
s-evirabg	1811	0.0002%	1333	0.00017%	3144
u-muulier	30966	0.0040%	1326	0.00017%	32292
pf-ld	15568	0.0020%	1322	0.00017%	16890
ruokafx5	739	0.0001%	1322	0.00017%	2061
bm-mgg	132	0.0000%	1322	0.00017%	1454
p-ca(7.4)	31027	0.0040%	1320	0.00017%	32347
li-liuskat	215	0.0000%	1319	0.00017%	1534
s-ige-ss	1708	0.0002%	1313	0.00017%	3021
b-co	13357	0.0017%	1309	0.00017%	14666
bm-mm-ift	399	0.0001%	1308	0.00017%	1707
l-muuta	142	0.0000%	1306	0.00017%	1448
li-ly	1483	0.0002%	1305	0.00017%	2788
s-goodpab	473	0.0001%	1302	0.00017%	1775
s-aldos	11985	0.0015%	1301	0.00017%	13286
s-prealb	182138	0.0235%	1298	0.00017%	183436
s-salmabg	190	0.0000%	1298	0.00017%	1488
p-keto-o	533	0.0001%	1297	0.00017%	1830
di-eos	332	0.0000%	1296	0.00017%	1628
s-rubeab	171	0.0000%	1294	0.00017%	1465
s-gangabm	268	0.0000%	1293	0.00017%	1561
di-ly+mono	289	0.0000%	1289	0.00017%	1578
di-neut	289	0.0000%	1288	0.00017%	1577
e-coombva	108	0.0000%	1288	0.00017%	1396
s-salmaba	191	0.0000%	1286	0.00017%	1477
li-rsvabg	115	0.0000%	1282	0.00017%	1397
p-kol	204957	0.0264%	1281	0.00017%	206238
li-alb	13425	0.0017%	1279	0.00017%	14704
b-ckmbmv	894	0.0001%	1274	0.00016%	2168
p-ca++hoi	690	0.0001%	1273	0.00016%	1963
s-bil-kj	16589	0.0021%	1270	0.00016%	17859
s-ebvavi	4265	0.0006%	1270	0.00016%	5535
s-ada	14716	0.0019%	1262	0.00016%	15978
u-huum-10,ominaispaino	595	0.0001%	1262	0.00016%	1857
muuttutk	144	0.0000%	1261	0.00016%	1405
mb-be	1192	0.0002%	1260	0.00016%	2452
b-tem	659	0.0001%	1259	0.00016%	1918
li-tau	6287	0.0008%	1258	0.00016%	7545
u-jcvnh	540	0.0001%	1254	0.00016%	1794
bm-lmark-h	428	0.0001%	1253	0.00016%	1681
u-bio	160	0.0000%	1253	0.00016%	1413
u-cot	454	0.0001%	1252	0.00016%	1706
l-mono%	58054	0.0075%	1250	0.00016%	59304
b-laktevt	1676	0.0002%	1248	0.00016%	2924
sprkiirlis	1055	0.0001%	1241	0.00016%	2296
l-monos-m	25028	0.0032%	1240	0.00016%	26268
u-huume-6a	105	0.0000%	1238	0.00016%	1343
ap-ca-ion	20974	0.0027%	1236	0.00016%	22210
-rievnho	104	0.0000%	1236	0.00016%	1340
sy-eos	3930	0.0005%	1235	0.00016%	5165
s-parpï¿½h	769	0.0001%	1234	0.00016%	2003
p-hb	16086	0.0021%	1233	0.00016%	17319
f-tricna	2030	0.0003%	1232	0.00016%	3262
b-mito.	3354	0.0004%	1229	0.00016%	4583
b-fidd	11588	0.0015%	1228	0.00016%	12816
pd-baktvi	223	0.0000%	1226	0.00016%	1449
vb-ph-vt	1555	0.0002%	1224	0.00016%	2779
-transf	962	0.0001%	1222	0.00016%	2184
-kat-vi	405	0.0001%	1222	0.00016%	1627
cb-tt-inr	14879	0.0019%	1218	0.00016%	16097
s-c1inh	5459	0.0007%	1216	0.00016%	6675
vb-he-tase,vb-pco2	1030	0.0001%	1216	0.00016%	2246
-stauvi	316	0.0000%	1212	0.00016%	1528
u-tbvi	257	0.0000%	1206	0.00016%	1463
b-nk	21205	0.0027%	1199	0.00015%	22404
u-albkre*	3093	0.0004%	1197	0.00015%	4290
s-gangabg	343	0.0000%	1194	0.00015%	1537
oma,pvk+t	1229	0.0002%	1192	0.00015%	2421
s-pappa	99914	0.0129%	1189	0.00015%	101103
beta2-glob	10470	0.0014%	1189	0.00015%	11659
fs-ct	1398	0.0002%	1185	0.00015%	2583
-ururnho	112	0.0000%	1185	0.00015%	1297
alfa1-glob	10473	0.0014%	1183	0.00015%	11656
s-c4	27439	0.0035%	1179	0.00015%	28618
bm-mrd-all	216	0.0000%	1177	0.00015%	1393
s-salmabm	315	0.0000%	1175	0.00015%	1490
p-lh	19640	0.0025%	1174	0.00015%	20814
s-ohrae	1269	0.0002%	1174	0.00015%	2443
pf-gran	2615	0.0003%	1171	0.00015%	3786
p-c3	37544	0.0048%	1159	0.00015%	38703
p-adennho	277	0.0000%	1159	0.00015%	1436
s-c3	28057	0.0036%	1158	0.00015%	29215
u-bkvnh	642	0.0001%	1156	0.00015%	1798
glukrvalm	329	0.0000%	1155	0.00015%	1484
as-alb	4751	0.0006%	1154	0.00015%	5905
p-c4	37509	0.0048%	1151	0.00015%	38660
-trvaag	286	0.0000%	1151	0.00015%	1437
ts-pad-ih2	280	0.0000%	1151	0.00015%	1431
s-igf1sds	2374	0.0003%	1145	0.00015%	3519
cb-bepika	7221	0.0009%	1144	0.00015%	8365
fb-gluk	2632	0.0003%	1144	0.00015%	3776
s-rubeabm	155	0.0000%	1144	0.00015%	1299
sa-korsol	8778	0.0011%	1139	0.00015%	9917
b-pnh-la	246	0.0000%	1139	0.00015%	1385
s-toxabcf	140	0.0000%	1136	0.00015%	1276
pf-lymf	1121	0.0001%	1135	0.00015%	2256
u-valvott	512	0.0001%	1134	0.00015%	1646
u-hyalier	31701	0.0041%	1129	0.00015%	32830
edta-veril	103	0.0000%	1129	0.00015%	1232
u-huum-7,ph	178	0.0000%	1128	0.00015%	1306
sy-ly+mono	4070	0.0005%	1127	0.00015%	5197
b-glukhoi	2045	0.0003%	1126	0.00015%	3171
p-trigly	164916	0.0213%	1123	0.00014%	166039
l-eos%	156800	0.0202%	1122	0.00014%	157922
s-kors/r	1850	0.0002%	1122	0.00014%	2972
s-pÃ¶lyeri	854	0.0001%	1122	0.00014%	1976
b-hla1pk	143	0.0000%	1122	0.00014%	1265
l-neut-m	28523	0.0037%	1121	0.00014%	29644
fl-flag	293	0.0000%	1117	0.00014%	1410
-cdt	1068	0.0001%	1116	0.00014%	2184
s-rcora14	497	0.0001%	1113	0.00014%	1610
s-bartab	194	0.0000%	1108	0.00014%	1302
oma-kol	804	0.0001%	1106	0.00014%	1910
__-rsvnho	142	0.0000%	1104	0.00014%	1246
vb-hco3	17402	0.0022%	1098	0.00014%	18500
b-hkrhoi	909	0.0001%	1097	0.00014%	2006
b-hepartp	230	0.0000%	1093	0.00014%	1323
sy-l/yksit	2103	0.0003%	1092	0.00014%	3195
sy-l/liusk	2102	0.0003%	1092	0.00014%	3194
-troptqpi	239	0.0000%	1092	0.00014%	1331
fp-ca-ion.	127820	0.0165%	1091	0.00014%	128911
p-bil-lap	50408	0.0065%	1091	0.00014%	51499
f-mm-o	330	0.0000%	1088	0.00014%	1418
s-teikab	212	0.0000%	1088	0.00014%	1300
u-kanna-o	113	0.0000%	1087	0.00014%	1200
pf-rf	359	0.0000%	1084	0.00014%	1443
b-t-cd8	11107	0.0014%	1083	0.00014%	12190
u-muuta	630	0.0001%	1082	0.00014%	1712
cb-gluk	19816	0.0026%	1081	0.00014%	20897
e-luov-vr	269	0.0000%	1079	0.00014%	1348
l-baso%	59764	0.0077%	1078	0.00014%	60842
b-fiddp	4917	0.0006%	1078	0.00014%	5995
p-reumafa	353	0.0000%	1078	0.00014%	1431
p-tni-o	431	0.0001%	1077	0.00014%	1508
ab-laktaat	19806	0.0026%	1071	0.00014%	20877
l-blastit*	814	0.0001%	1071	0.00014%	1885
l-promyel*	814	0.0001%	1071	0.00014%	1885
f-hb-hum	904	0.0001%	1068	0.00014%	1972
fluor,nat,fl-leuk	189	0.0000%	1066	0.00014%	1255
-activi	164	0.0000%	1066	0.00014%	1230
baso	265452	0.0343%	1062	0.00014%	266514
s-glpepabg	1002	0.0001%	1062	0.00014%	2064
fluor,nat,fl-hiiva	195	0.0000%	1060	0.00014%	1255
fluor,nat,fl-clue	193	0.0000%	1060	0.00014%	1253
fluor,nat,muuta	188	0.0000%	1059	0.00014%	1247
l-lymf-m	24389	0.0031%	1058	0.00014%	25447
l-lymf-m	238	0.0000%	1058	0.00014%	1296
b-calr-d	136	0.0000%	1057	0.00014%	1193
ghb-a1c(vo.hoitaja)	1542	0.0002%	1056	0.00014%	2598
u-alb-lb	1180	0.0002%	1056	0.00014%	2236
s-anca-c	105	0.0000%	1055	0.00014%	1160
vb-pco2-vt	1686	0.0002%	1054	0.00014%	2740
ly-t-cd4/8	5889	0.0008%	1052	0.00014%	6941
b-hla1mun	123	0.0000%	1049	0.00014%	1172
b-ghba1c/p	3115	0.0004%	1048	0.00014%	4163
u-metadct	312	0.0000%	1043	0.00013%	1355
e-cmbiga	252	0.0000%	1043	0.00013%	1295
e-cmbigg	252	0.0000%	1043	0.00013%	1295
e-cmbigm	252	0.0000%	1043	0.00013%	1295
nÃ¤kÃ¶seula	230	0.0000%	1043	0.00013%	1273
li-lmark-h	273	0.0000%	1041	0.00013%	1314
e-cmbc3c	252	0.0000%	1041	0.00013%	1293
e-cmbc3d	252	0.0000%	1041	0.00013%	1293
s-ancif	308	0.0000%	1040	0.00013%	1348
oma-troponiini	223	0.0000%	1040	0.00013%	1263
u-huum-10,ph	831	0.0001%	1039	0.00013%	1870
s-ck-is	154	0.0000%	1039	0.00013%	1193
li-muut	319	0.0000%	1038	0.00013%	1357
s-igf1	37114	0.0048%	1034	0.00013%	38148
inrvieri	7569	0.0010%	1034	0.00013%	8603
vb-bepika	4544	0.0006%	1034	0.00013%	5578
s-gliade	225	0.0000%	1030	0.00013%	1255
b-t-cd3	11055	0.0014%	1029	0.00013%	12084
s-gbmif	135	0.0000%	1020	0.00013%	1155
pf-amyl	2182	0.0003%	1018	0.00013%	3200
lymf	272789	0.0352%	1017	0.00013%	273806
u-ca	11368	0.0015%	1017	0.00013%	12385
pf-liuskat	1313	0.0002%	1015	0.00013%	2328
psavapaanjatotaalinsuhde	285	0.0000%	1010	0.00013%	1295
b-brcay-d	197	0.0000%	1008	0.00013%	1205
s-adali	2279	0.0003%	1003	0.00013%	3282
pt-gfr	268	0.0000%	1002	0.00013%	1270
pt-ttr+inr	3327	0.0004%	999	0.00013%	4326
b-lydikll	378	0.0000%	998	0.00013%	1376
s-rcora9e	1236	0.0002%	995	0.00013%	2231
tropopika	122	0.0000%	995	0.00013%	1117
s-hhv6abg	2986	0.0004%	994	0.00013%	3980
s-ruoer	453	0.0001%	994	0.00013%	1447
s-aitendo	110	0.0000%	993	0.00013%	1103
s-mantele	3110	0.0004%	991	0.00013%	4101
vb-ahco3vt	1482	0.0002%	989	0.00013%	2471
s-ucrp	7332	0.0009%	988	0.00013%	8320
p-fiddpik	3441	0.0004%	986	0.00013%	4427
tupakka	5709	0.0007%	983	0.00013%	6692
s-psavapaanjatotaalinsuhde	559	0.0001%	982	0.00013%	1541
as-mononuk	1308	0.0002%	981	0.00013%	2289
pika-crptyÃ¶terveysasemalla	1367	0.0002%	979	0.00013%	2346
gluteeni	132	0.0000%	976	0.00013%	1108
s-bor-abg	384	0.0000%	973	0.00013%	1357
s-igg-oc	3450	0.0004%	967	0.00012%	4417
mono	176377	0.0228%	962	0.00012%	177339
beta1-glob	10528	0.0014%	960	0.00012%	11488
b-gluk-pika	330	0.0000%	958	0.00012%	1288
b-edtatutk	161	0.0000%	957	0.00012%	1118
ap-cl	1113	0.0001%	955	0.00012%	2068
eos	237731	0.0307%	950	0.00012%	238681
b-gluk-o	1144	0.0001%	947	0.00012%	2091
cb-inr-o	5068	0.0007%	945	0.00012%	6013
pef-seurantavastaanotolla	512	0.0001%	943	0.00012%	1455
b-biodna	349	0.0000%	943	0.00012%	1292
pt-kt/v1	10137	0.0013%	941	0.00012%	11078
s-scc-ag	2421	0.0003%	940	0.00012%	3361
s-bor-abm	418	0.0001%	940	0.00012%	1358
b-panel-m	328	0.0000%	940	0.00012%	1268
nu-alb	3647	0.0005%	933	0.00012%	4580
p-luakrvv	10519	0.0014%	932	0.00012%	11451
ab-shco3	286534	0.0370%	931	0.00012%	287465
-urpanho	145	0.0000%	931	0.00012%	1076
ts-abortti	197	0.0000%	930	0.00012%	1127
b-cyp2d6	140	0.0000%	929	0.00012%	1069
s-kysc	24678	0.0032%	924	0.00012%	25602
s-ebvabm	6930	0.0009%	923	0.00012%	7853
igakeli	269	0.0000%	923	0.00012%	1192
p-at3	80487	0.0104%	922	0.00012%	81409
s-inaabcf	395	0.0001%	922	0.00012%	1317
p-haptog	47666	0.0062%	921	0.00012%	48587
s-risper	1294	0.0002%	921	0.00012%	2215
s-nbosd6e	595	0.0001%	921	0.00012%	1516
fp-c-vit	397	0.0001%	920	0.00012%	1317
uv-pco2	15514	0.0020%	918	0.00012%	16432
p-tnt-hoi	121	0.0000%	915	0.00012%	1036
s-mogab	366	0.0000%	912	0.00012%	1278
c-anca	118	0.0000%	911	0.00012%	1029
p-luakptt	10579	0.0014%	906	0.00012%	11485
ly-t-cd3	11226	0.0014%	904	0.00012%	12130
pd-solut	1114	0.0001%	904	0.00012%	2018
s-kaseiie	3702	0.0005%	903	0.00012%	4605
li-laktaat	16579	0.0021%	902	0.00012%	17481
s-trypt	10557	0.0014%	899	0.00012%	11456
s-mpnabcf	170	0.0000%	898	0.00012%	1068
ly-nk	11165	0.0014%	897	0.00012%	12062
di-ph	1941	0.0003%	897	0.00012%	2838
s-hbs-ab	475	0.0001%	894	0.00012%	1369
b-b-cd19	11403	0.0015%	893	0.00012%	12296
p-hok	137	0.0000%	893	0.00012%	1030
pt-fib-4	4292	0.0006%	888	0.00011%	5180
b-pcr-kim	517	0.0001%	886	0.00011%	1403
-staupvl	146	0.0000%	886	0.00011%	1032
s-dheas	15356	0.0020%	883	0.00011%	16239
as-gran	909	0.0001%	882	0.00011%	1791
afossuoli	1115	0.0001%	878	0.00011%	1993
p-fviii	10497	0.0014%	877	0.00011%	11374
vb-caionvt	1174	0.0002%	876	0.00011%	2050
s-stpn5	875	0.0001%	874	0.00011%	1749
cv-trinho	193	0.0000%	873	0.00011%	1066
vb-hco3-st	210675	0.0272%	872	0.00011%	211547
vb-laktaat	24655	0.0032%	869	0.00011%	25524
b-mono	501138	0.0647%	867	0.00011%	502005
fs-c-pept	33584	0.0043%	863	0.00011%	34447
vehnÃ¤,ruok	646	0.0001%	863	0.00011%	1509
-solut	497	0.0001%	863	0.00011%	1360
uv-po2	12041	0.0016%	862	0.00011%	12903
as-lymf	474	0.0001%	860	0.00011%	1334
s-tpo-ab	686	0.0001%	859	0.00011%	1545
ly-b-cd19	6329	0.0008%	854	0.00011%	7183
f-veri-o	925	0.0001%	840	0.00011%	1765
u-opiaact	150	0.0000%	837	0.00011%	987
p-gluk-2h	8526	0.0011%	833	0.00011%	9359
b-hla-bw	116	0.0000%	832	0.00011%	948
u-osmol	34099	0.0044%	831	0.00011%	34930
s-legiabm	176	0.0000%	830	0.00011%	1006
f-transf2	354	0.0000%	828	0.00011%	1182
s-legiabg	179	0.0000%	827	0.00011%	1006
s-chtraba	253	0.0000%	825	0.00011%	1078
nu-alb-mi	1313	0.0002%	821	0.00011%	2134
ts-tcr-d	106	0.0000%	818	0.00011%	924
s-etohgc	620	0.0001%	817	0.00011%	1437
oma-inr-pika	110	0.0000%	816	0.00011%	926
-llajitt	239	0.0000%	815	0.00011%	1054
p-anca	216	0.0000%	815	0.00011%	1031
s-aitpara	365	0.0000%	813	0.00010%	1178
fp-cga	20672	0.0027%	812	0.00010%	21484
neut	242753	0.0313%	810	0.00010%	243563
pf-neut	4833	0.0006%	810	0.00010%	5643
cp-glukpaa	771	0.0001%	809	0.00010%	1580
tntvieri	125	0.0000%	809	0.00010%	934
s-tni	634	0.0001%	808	0.00010%	1442
s-anca-p	354	0.0000%	806	0.00010%	1160
p-d-25	149611	0.0193%	805	0.00010%	150416
vb-temp	24533	0.0032%	805	0.00010%	25338
s-prog	12374	0.0016%	805	0.00010%	13179
vieri-inr	4544	0.0006%	805	0.00010%	5349
s-stpn1	986	0.0001%	803	0.00010%	1789
u-albkrlb	717	0.0001%	802	0.00010%	1519
s-igd	998	0.0001%	801	0.00010%	1799
u-albkrea*	1860	0.0002%	798	0.00010%	2658
s-insu	26209	0.0034%	796	0.00010%	27005
s-b2miglo	18657	0.0024%	796	0.00010%	19453
u-leukla	23531	0.0030%	793	0.00010%	24324
u-erytla	23527	0.0030%	793	0.00010%	24320
s-stpn4	956	0.0001%	793	0.00010%	1749
s-aitneu	717	0.0001%	793	0.00010%	1510
u-epitla	23526	0.0030%	790	0.00010%	24316
u-lierla	23509	0.0030%	790	0.00010%	24299
s-ovarab	149	0.0000%	789	0.00010%	938
p-prealb	54885	0.0071%	787	0.00010%	55672
glukoosi(hoitaja)	4389	0.0006%	784	0.00010%	5173
audit	5616	0.0007%	783	0.00010%	6399
hpvnho	377	0.0000%	782	0.00010%	1159
s-hcgo-lb	126	0.0000%	782	0.00010%	908
cu-kesto	7913	0.0010%	781	0.00010%	8694
us-t4-v	903	0.0001%	777	0.00010%	1680
u-makrof	1385	0.0002%	776	0.00010%	2161
alfa2-glob	10885	0.0014%	775	0.00010%	11660
s-rarah6e	3584	0.0005%	770	0.00010%	4354
b-vrabtu	918	0.0001%	767	0.00010%	1685
p-jcvnh	228	0.0000%	766	0.00010%	994
kilpirauhastutkimuspaketti	165	0.0000%	765	0.00010%	930
ab-hco3-st	365385	0.0472%	764	0.00010%	366149
b-hemocue	1509	0.0002%	763	0.00010%	2272
s-stpn14	988	0.0001%	762	0.00010%	1750
u-as-i	241	0.0000%	760	0.00010%	1001
bm-lydikll	213	0.0000%	760	0.00010%	973
f-calpro2	3327	0.0004%	756	0.00010%	4083
s-hladsa	223	0.0000%	755	0.00010%	978
ly-t-cd8	7123	0.0009%	753	0.00010%	7876
s-pl7ab-o	398	0.0001%	753	0.00010%	1151
s-jo1ab-o	398	0.0001%	753	0.00010%	1151
s-kuab-o	398	0.0001%	753	0.00010%	1151
s-ejab-o	398	0.0001%	753	0.00010%	1151
s-srpab-o	398	0.0001%	753	0.00010%	1151
s-pm75abo	398	0.0001%	753	0.00010%	1151
s-pm100-o	398	0.0001%	753	0.00010%	1151
s-pl12-o	398	0.0001%	753	0.00010%	1151
s-ojab-o	397	0.0001%	753	0.00010%	1150
s-ssa52-o	397	0.0001%	753	0.00010%	1150
s-hcg-b	618	0.0001%	752	0.00010%	1370
s-envabcf	536	0.0001%	750	0.00010%	1286
s-alfgale	1144	0.0001%	746	0.00010%	1890
pt-lÃ¤mpÃ¶t	352502	0.0455%	745	0.00010%	353247
s-infliks	5373	0.0007%	744	0.00010%	6117
la-cd34-ks	195	0.0000%	744	0.00010%	939
-hcvnho	183	0.0000%	740	0.00010%	923
s-stpn9v	1012	0.0001%	737	0.00010%	1749
cu-tilav	7715	0.0010%	733	0.00009%	8448
cb-inr-vt	2545	0.0003%	733	0.00009%	3278
fp-gluk-0h	2552	0.0003%	732	0.00009%	3284
s-stpn6b	1019	0.0001%	732	0.00009%	1751
s-ana(ait)	488	0.0001%	732	0.00009%	1220
-unÃ¤kÃ¶-n	472	0.0001%	732	0.00009%	1204
s-raiheie	435	0.0001%	732	0.00009%	1167
s-lehmÃ¤e	657	0.0001%	730	0.00009%	1387
ts-lisÃ¤his	414	0.0001%	730	0.00009%	1144
ab-hbo2	572302	0.0739%	726	0.00009%	573028
am-kromos	119	0.0000%	726	0.00009%	845
u-pyr	261	0.0000%	725	0.00009%	986
-diffi	471	0.0001%	724	0.00009%	1195
vb-gluk	22917	0.0030%	723	0.00009%	23640
s-adeabcf	571	0.0001%	723	0.00009%	1294
s-ancabk	670	0.0001%	722	0.00009%	1392
l-basof	165252	0.0213%	718	0.00009%	165970
p-preurea	6160	0.0008%	717	0.00009%	6877
s-leppï¿½e	724	0.0001%	716	0.00009%	1440
b-gluk-pi	344	0.0000%	715	0.00009%	1059
p-il6	1296	0.0002%	714	0.00009%	2010
b-edta	331	0.0000%	714	0.00009%	1045
b-caionpf	2846	0.0004%	713	0.00009%	3559
fs-gluk	130796	0.0169%	709	0.00009%	131505
b-hb-f	3674	0.0005%	709	0.00009%	4383
l-neutr	142941	0.0184%	708	0.00009%	143649
p-apcres.	9774	0.0013%	706	0.00009%	10480
kala,tursk	217	0.0000%	704	0.00009%	921
b-rethe	15782	0.0020%	703	0.00009%	16485
s-norklot	28704	0.0037%	700	0.00009%	29404
du-alb	3109	0.0004%	700	0.00009%	3809
pt-krea-cl	1834	0.0002%	699	0.00009%	2533
-hbvnh	127	0.0000%	699	0.00009%	826
s-testab	133	0.0000%	697	0.00009%	830
s-ruokae	1374	0.0002%	696	0.00009%	2070
s-Ã¤itseul*	390	0.0001%	694	0.00009%	1084
ab-o2hb	8708	0.0011%	692	0.00009%	9400
as-l/liusk	612	0.0001%	688	0.00009%	1300
-pvlnho	110	0.0000%	688	0.00009%	798
ab-to2c	8559	0.0011%	687	0.00009%	9246
as-l/yksit	612	0.0001%	687	0.00009%	1299
p-hivnhre	104	0.0000%	687	0.00009%	791
u-eddp-o	215	0.0000%	683	0.00009%	898
s-stpn19f	1069	0.0001%	681	0.00009%	1750
l-lymfos	162962	0.0210%	680	0.00009%	163642
b-leuk-vt	8359	0.0011%	679	0.00009%	9038
s-tymidk	7690	0.0010%	679	0.00009%	8369
-leginho	149	0.0000%	679	0.00009%	828
se-amyl	3842	0.0005%	678	0.00009%	4520
s-probnp	4484	0.0006%	676	0.00009%	5160
s-stpn23f	1073	0.0001%	675	0.00009%	1748
l-eosin	145398	0.0188%	674	0.00009%	146072
gamma-glob	11284	0.0015%	674	0.00009%	11958
-verkoh	300	0.0000%	674	0.00009%	974
s-haspï¿½he	2074	0.0003%	673	0.00009%	2747
p-vwf-akt	11927	0.0015%	669	0.00009%	12596
s-hav-abg	316	0.0000%	669	0.00009%	985
pd-neut+eo	500	0.0001%	667	0.00009%	1167
c-reaktiivinenproteiini	4151	0.0005%	665	0.00009%	4816
s-psav/t	2786	0.0004%	664	0.00009%	3450
pt-sep	641	0.0001%	663	0.00009%	1304
pt-utp-2	293	0.0000%	663	0.00009%	956
sk-kromos	141	0.0000%	662	0.00009%	803
s-osmol	19870	0.0026%	660	0.00009%	20530
b-myogl-v	1508	0.0002%	659	0.00009%	2167
s-latekse	839	0.0001%	657	0.00008%	1496
s-salis	691	0.0001%	657	0.00008%	1348
u-gcnho*	461	0.0001%	655	0.00008%	1116
keliakiatutkimus,suppea	158	0.0000%	652	0.00008%	810
li-aitneu	271	0.0000%	651	0.00008%	922
s-stpn7f	1100	0.0001%	649	0.00008%	1749
s-inbabcf	665	0.0001%	648	0.00008%	1313
-sienlm	104	0.0000%	646	0.00008%	750
cu-igg	387	0.0000%	639	0.00008%	1026
sy-sameus	4784	0.0006%	635	0.00008%	5419
fev1	1529	0.0002%	635	0.00008%	2164
s-ami	826	0.0001%	635	0.00008%	1461
s-stpn18c	1117	0.0001%	633	0.00008%	1750
u-cakre	582	0.0001%	633	0.00008%	1215
l-myel	55643	0.0072%	632	0.00008%	56275
fvc	1531	0.0002%	631	0.00008%	2162
u-solut,muut	619	0.0001%	631	0.00008%	1250
fev%	815	0.0001%	630	0.00008%	1445
du-metnef	6729	0.0009%	628	0.00008%	7357
d-dimer	1521	0.0002%	625	0.00008%	2146
u-etgct	117	0.0000%	625	0.00008%	742
ts-makon-d	148	0.0000%	623	0.00008%	771
p-reninm	17663	0.0023%	622	0.00008%	18285
p-mypa	3078	0.0004%	621	0.00008%	3699
ab-lÃ¤mpÃ¶ti	23876	0.0031%	618	0.00008%	24494
s-gen	1454	0.0002%	618	0.00008%	2072
b-mxa	1013	0.0001%	617	0.00008%	1630
-diagn..	160	0.0000%	617	0.00008%	777
cb-bil-mi	20681	0.0027%	616	0.00008%	21297
s-leuab2	189	0.0000%	615	0.00008%	804
p-fidd-vt	6189	0.0008%	612	0.00008%	6801
am-unÃ¤kÃ¶	136	0.0000%	611	0.00008%	747
suolis-is	767	0.0001%	606	0.00008%	1373
b-edta5/4	111	0.0000%	604	0.00008%	715
u-etsct	115	0.0000%	603	0.00008%	718
fb-b1-vit	10919	0.0014%	602	0.00008%	11521
f-transf3	271	0.0000%	599	0.00008%	870
p-lakveka	32330	0.0042%	597	0.00008%	32927
fs-kol-hdl	1138106	0.1469%	594	0.00008%	1138700
fs-ca++7.4	89263	0.0115%	594	0.00008%	89857
cb-chb	10117	0.0013%	593	0.00008%	10710
crp-vt	1763	0.0002%	593	0.00008%	2356
u-etg	140	0.0000%	593	0.00008%	733
s-ruok5ry	1344	0.0002%	591	0.00008%	1935
s-tomaate	860	0.0001%	591	0.00008%	1451
li-baktnho	152	0.0000%	591	0.00008%	743
b-vara	123	0.0000%	590	0.00008%	713
s-lohie	1976	0.0003%	589	0.00008%	2565
li-neut	1573	0.0002%	589	0.00008%	2162
cp-ohbutpo	1288	0.0002%	589	0.00008%	1877
s-k	525613	0.0678%	588	0.00008%	526201
b-hbf-fc	201	0.0000%	587	0.00008%	788
globuliini	2513	0.0003%	584	0.00008%	3097
s-maapÃ¤ek	401	0.0001%	582	0.00008%	983
vb-he-tase,vb-hb	879	0.0001%	581	0.00007%	1460
oma-hb-a1c	869	0.0001%	581	0.00007%	1450
inkub.1vrk	163	0.0000%	580	0.00007%	743
-staunho	170	0.0000%	579	0.00007%	749
sy-muut	116	0.0000%	579	0.00007%	695
s-elÃ¤iner	1044	0.0001%	577	0.00007%	1621
fs-cga	12597	0.0016%	573	0.00007%	13170
p-fsh	30302	0.0039%	569	0.00007%	30871
fvc/brdil	780	0.0001%	569	0.00007%	1349
s-he4	31445	0.0041%	568	0.00007%	32013
fev1/brdil	781	0.0001%	568	0.00007%	1349
fev%/brdil	781	0.0001%	568	0.00007%	1349
maito	661	0.0001%	568	0.00007%	1229
-lisÃ¤ma1	429	0.0001%	568	0.00007%	997
l-prom	40067	0.0052%	564	0.00007%	40631
sensori	1570	0.0002%	564	0.00007%	2134
s-nse	29207	0.0038%	563	0.00007%	29770
ts-trinho	250	0.0000%	562	0.00007%	812
u-pi	4556	0.0006%	561	0.00007%	5117
-troptqpik	132	0.0000%	561	0.00007%	693
s-viseabg	645	0.0001%	560	0.00007%	1205
e-rethe	27192	0.0035%	559	0.00007%	27751
s-ebvnabg	538	0.0001%	558	0.00007%	1096
l-meta	38456	0.0050%	557	0.00007%	39013
cd4	10254	0.0013%	557	0.00007%	10811
ab-bio-0	150	0.0000%	556	0.00007%	706
p-psamob	1895	0.0002%	554	0.00007%	2449
pf-l/liusk	1126	0.0001%	554	0.00007%	1680
pf-l/yksit	1126	0.0001%	554	0.00007%	1680
erik.nÃ¤yte	995	0.0001%	553	0.00007%	1548
p-gluveka	32313	0.0042%	552	0.00007%	32865
p-pc	20897	0.0027%	551	0.00007%	21448
cd4/cd8	9743	0.0013%	551	0.00007%	10294
cp-na	11390	0.0015%	550	0.00007%	11940
nt-	2794	0.0004%	549	0.00007%	3343
li-lymf	652	0.0001%	549	0.00007%	1201
s-rsvabcf	767	0.0001%	548	0.00007%	1315
s-shbg	79421	0.0102%	547	0.00007%	79968
s-hivab	680	0.0001%	546	0.00007%	1226
u-hcg	421	0.0001%	546	0.00007%	967
u-om.p.	2298	0.0003%	542	0.00007%	2840
soijapapu	566	0.0001%	540	0.00007%	1106
k-pika	24274	0.0031%	538	0.00007%	24812
s-b12t-c2	322	0.0000%	538	0.00007%	860
inkub.2vrk	183	0.0000%	538	0.00007%	721
ks-viabil	109	0.0000%	538	0.00007%	647
igepujo	156	0.0000%	537	0.00007%	693
astmatesti	742	0.0001%	536	0.00007%	1278
u-pbg-o	119	0.0000%	535	0.00007%	654
b-crp-tth	839	0.0001%	534	0.00007%	1373
s-mg-ion	12808	0.0017%	529	0.00007%	13337
s-ihot-ab	207	0.0000%	528	0.00007%	735
fs-pp	2562	0.0003%	526	0.00007%	3088
na-pika	24213	0.0031%	525	0.00007%	24738
du-normet	6860	0.0009%	525	0.00007%	7385
s-vehnÃ¤ek	239	0.0000%	524	0.00007%	763
b-lmark	133	0.0000%	524	0.00007%	657
cp-ca-ion	11222	0.0014%	519	0.00007%	11741
as-prot	3377	0.0004%	518	0.00007%	3895
fp-kol-ind	37749	0.0049%	517	0.00007%	38266
pika-crp-o	10102	0.0013%	517	0.00007%	10619
pd-lymf+mo	281	0.0000%	517	0.00007%	798
vb-lÃ¤mpÃ¶ti	10293	0.0013%	516	0.00007%	10809
b-heparab	218	0.0000%	516	0.00007%	734
-opitulos	126	0.0000%	516	0.00007%	642
bm-soluvi	101	0.0000%	516	0.00007%	617
b-tcr-d	136	0.0000%	514	0.00007%	650
s-caion7.4	34033	0.0044%	513	0.00007%	34546
e-aborh*	427	0.0001%	512	0.00007%	939
pt-ttlaite	163	0.0000%	509	0.00007%	672
-cantulos	133	0.0000%	509	0.00007%	642
diabetes	1626	0.0002%	508	0.00007%	2134
as-leuk	9752	0.0013%	507	0.00007%	10259
s-leuab1	299	0.0000%	506	0.00007%	805
p-fidd-lb	12138	0.0016%	504	0.00007%	12642
p-tt-inr-o	502	0.0001%	504	0.00007%	1006
c-reakt.prot,oma	408	0.0001%	502	0.00006%	910
s-parvnho	110	0.0000%	502	0.00006%	612
b-lÃ¤Ã¤k-hu	139	0.0000%	501	0.00006%	640
s-caspek	496	0.0001%	500	0.00006%	996
b-cd3	18336	0.0024%	499	0.00006%	18835
b-fidd-o	5623	0.0007%	498	0.00006%	6121
fs-krea	1049601	0.1355%	496	0.00006%	1050097
u-mygenho	318	0.0000%	496	0.00006%	814
s-brucab	220	0.0000%	496	0.00006%	716
rf	175	0.0000%	496	0.00006%	671
du-krea	3642	0.0005%	495	0.00006%	4137
b-hla2frk	106	0.0000%	495	0.00006%	601
pt-lakt-r1	135	0.0000%	493	0.00006%	628
s-antitry	18833	0.0024%	492	0.00006%	19325
s-clteab	1842	0.0002%	491	0.00006%	2333
du-tilav	10028	0.0013%	488	0.00006%	10516
ly-tbspota	3317	0.0004%	487	0.00006%	3804
leukpika	3079	0.0004%	487	0.00006%	3566
s-maitoek	271	0.0000%	487	0.00006%	758
s-hcgbv/d	47884	0.0062%	486	0.00006%	48370
s-ruisjae	1275	0.0002%	486	0.00006%	1761
ab-k	8705	0.0011%	483	0.00006%	9188
s-soijaek	149	0.0000%	478	0.00006%	627
s-testo-v	7179	0.0009%	477	0.00006%	7656
ab-hkr	8451	0.0011%	475	0.00006%	8926
s-mi-2	170	0.0000%	475	0.00006%	645
fb-folaat	18271	0.0024%	473	0.00006%	18744
p-urea-dj	13946	0.0018%	473	0.00006%	14419
b-hba1c-p	12274	0.0016%	470	0.00006%	12744
b-tacroms	33124	0.0043%	469	0.00006%	33593
s-rcora1e	2729	0.0004%	468	0.00006%	3197
u-inh-o	135	0.0000%	466	0.00006%	601
krea-pika	23444	0.0030%	464	0.00006%	23908
s-munavek	301	0.0000%	464	0.00006%	765
pf-ace	976	0.0001%	462	0.00006%	1438
s-magab	154	0.0000%	462	0.00006%	616
u-intp	7744	0.0010%	460	0.00006%	8204
ab-ph(t)	17937	0.0023%	459	0.00006%	18396
maapÃ¤hkinÃ¤	1095	0.0001%	457	0.00006%	1552
pt-paino	6911	0.0009%	456	0.00006%	7367
b-hbfvol	214	0.0000%	455	0.00006%	669
prostataspesifinenantigeeni,vapaa	1345	0.0002%	453	0.00006%	1798
s-achrab	248	0.0000%	452	0.00006%	700
b-hhb	5393	0.0007%	451	0.00006%	5844
s-maissie	508	0.0001%	451	0.00006%	959
s-adioni	7389	0.0010%	450	0.00006%	7839
s-munakee	733	0.0001%	450	0.00006%	1183
c-reaktiivinenproteiini,vieritutkimusnordlab	578	0.0001%	449	0.00006%	1027
b-hb-f-vr	213	0.0000%	449	0.00006%	662
ly-cd4/cd8	8144	0.0011%	446	0.00006%	8590
ana	114	0.0000%	443	0.00006%	557
p-ph	21034	0.0027%	441	0.00006%	21475
cp-k	11500	0.0015%	441	0.00006%	11941
s-afsuoli	545	0.0001%	441	0.00006%	986
s-enaseul	401	0.0001%	441	0.00006%	842
b-jcv	100	0.0000%	441	0.00006%	541
s-altalte	196	0.0000%	440	0.00006%	636
b-k-v	616	0.0001%	439	0.00006%	1055
p-c1qabg	180	0.0000%	437	0.00006%	617
du-mg	1855	0.0002%	436	0.00006%	2291
s-extra	355	0.0000%	436	0.00006%	791
peak	255	0.0000%	436	0.00006%	691
u-al	1081	0.0001%	435	0.00006%	1516
s-borabgv	540	0.0001%	435	0.00006%	975
s-gliadie	2282	0.0003%	434	0.00006%	2716
cb-gluk-v	977	0.0001%	432	0.00006%	1409
b-inr-pik	33638	0.0043%	431	0.00006%	34069
du-cu	699	0.0001%	431	0.00006%	1130
s-kaurjae	1378	0.0002%	429	0.00006%	1807
-amftulos	213	0.0000%	429	0.00006%	642
p-fv	17311	0.0022%	428	0.00006%	17739
ab-be-vt	384	0.0000%	427	0.00006%	811
s-amokige	352	0.0000%	427	0.00006%	779
u-naftol	352	0.0000%	426	0.00005%	778
as-neut+eo	562	0.0001%	425	0.00005%	987
s-amokse	233	0.0000%	425	0.00005%	658
muut	60911	0.0079%	424	0.00005%	61335
li-eos	1087	0.0001%	424	0.00005%	1511
li-leukmuu	535	0.0001%	424	0.00005%	959
p-fidd-hy	1321	0.0002%	422	0.00005%	1743
pf-c4	821	0.0001%	422	0.00005%	1243
bla	21326	0.0028%	421	0.00005%	21747
p-krea-vt	17011	0.0022%	420	0.00005%	17431
li-monos	1257	0.0002%	419	0.00005%	1676
as-liuskat	381	0.0000%	418	0.00005%	799
vekapak1	352231	0.0455%	416	0.00005%	352647
u-hb	207	0.0000%	416	0.00005%	623
s-rib-pab	188	0.0000%	416	0.00005%	604
sy-pmn	2305	0.0003%	414	0.00005%	2719
b-6-tgn	1961	0.0003%	414	0.00005%	2375
ab-pco2(t)	17956	0.0023%	413	0.00005%	18369
ub-leuk	334	0.0000%	412	0.00005%	746
b-edtaproj	216	0.0000%	411	0.00005%	627
enaab	144	0.0000%	411	0.00005%	555
u-k	13722	0.0018%	410	0.00005%	14132
b-panel-s	455	0.0001%	410	0.00005%	865
s-paroabg	377	0.0000%	410	0.00005%	787
prom	32705	0.0042%	408	0.00005%	33113
s-ohrajae	1181	0.0002%	408	0.00005%	1589
alkopuhal	167	0.0000%	408	0.00005%	575
ghb-a1c-pi	127	0.0000%	408	0.00005%	535
c-reaktiivinenproteiini-pika	555	0.0001%	407	0.00005%	962
s-ifx	4093	0.0005%	403	0.00005%	4496
s-cora1e	369	0.0000%	403	0.00005%	772
ab-chb	19663	0.0025%	401	0.00005%	20064
ex-neut	395	0.0001%	401	0.00005%	796
l-blasti	145	0.0000%	401	0.00005%	546
s-ecp	15844	0.0020%	400	0.00005%	16244
s-piiinp	7165	0.0009%	400	0.00005%	7565
sy-ly	4884	0.0006%	400	0.00005%	5284
sy-laktaat	602	0.0001%	400	0.00005%	1002
pt-ekg-fas	500	0.0001%	399	0.00005%	899
p-c1inhbk	5663	0.0007%	397	0.00005%	6060
se-bil	1611	0.0002%	397	0.00005%	2008
bnppika	249	0.0000%	397	0.00005%	646
du-pi	1706	0.0002%	395	0.00005%	2101
s-ana-ab	110	0.0000%	395	0.00005%	505
ua-hco3-st	37901	0.0049%	394	0.00005%	38295
ub-eryt	333	0.0000%	393	0.00005%	726
crpvieritesti	515	0.0001%	392	0.00005%	907
p-tt-inrqc	4360	0.0006%	391	0.00005%	4751
s-heiner	253	0.0000%	391	0.00005%	644
b-cd19	18341	0.0024%	390	0.00005%	18731
b-cd8	18337	0.0024%	389	0.00005%	18726
b-cd4	18340	0.0024%	387	0.00005%	18727
s-kaniepe	399	0.0001%	387	0.00005%	786
kt/v	4289	0.0006%	386	0.00005%	4675
p-laktaat	123379	0.0159%	385	0.00005%	123764
ub-trom	343	0.0000%	384	0.00005%	727
li-aitpara	157	0.0000%	384	0.00005%	541
s-cob5abg	926	0.0001%	382	0.00005%	1308
ub-hb	358	0.0000%	382	0.00005%	740
s-koopï¿½he	250	0.0000%	382	0.00005%	632
ps-stranho	235	0.0000%	382	0.00005%	617
pt-apri	3138	0.0004%	381	0.00005%	3519
ikÃ¤ryhmÃ¤	2397	0.0003%	381	0.00005%	2778
sy-liuskat	1279	0.0002%	381	0.00005%	1660
ub-hkr	345	0.0000%	381	0.00005%	726
s-vpenige	292	0.0000%	381	0.00005%	673
di-solut	1449	0.0002%	380	0.00005%	1829
pf-c3	848	0.0001%	380	0.00005%	1228
s-tattare	395	0.0001%	380	0.00005%	775
s-tygl-ab	238	0.0000%	380	0.00005%	618
p-b12-vit	188056	0.0243%	379	0.00005%	188435
s-mypn-abm	155	0.0000%	379	0.00005%	534
ue-mch	346	0.0000%	378	0.00005%	724
ue-mchc	346	0.0000%	378	0.00005%	724
ue-mcv	345	0.0000%	378	0.00005%	723
b-tni	133	0.0000%	378	0.00005%	511
s-pinfabcf	932	0.0001%	377	0.00005%	1309
s-myplabg	608	0.0001%	376	0.00005%	984
u-amyl	17456	0.0023%	375	0.00005%	17831
s-leppÃ¤e	1783	0.0002%	375	0.00005%	2158
b-tt-inrv	14995	0.0019%	373	0.00005%	15368
s-fenyt	9498	0.0012%	372	0.00005%	9870
s-statrae	373	0.0000%	372	0.00005%	745
s-riisie	356	0.0000%	372	0.00005%	728
s-lamotri	8027	0.0010%	370	0.00005%	8397
s-caspÃ¤he	5683	0.0007%	369	0.00005%	6052
b-glu-liu	119	0.0000%	369	0.00005%	488
l-baso(a)	195696	0.0253%	368	0.00005%	196064
virtsam.	11298	0.0015%	368	0.00005%	11666
s-aspvere	512	0.0001%	366	0.00005%	878
p-ps	8394	0.0011%	365	0.00005%	8759
s-mehmyre	907	0.0001%	365	0.00005%	1272
p-fviiiab	262	0.0000%	364	0.00005%	626
s-normet	21489	0.0028%	363	0.00005%	21852
myel	32814	0.0042%	362	0.00005%	33176
pika-gluk	28800	0.0037%	362	0.00005%	29162
kissaige	113	0.0000%	362	0.00005%	475
s-epo	22059	0.0028%	361	0.00005%	22420
fp-rf	178	0.0000%	361	0.00005%	539
s-afossuo	515	0.0001%	360	0.00005%	875
cb-o2-sis	12601	0.0016%	359	0.00005%	12960
s-insuaab	399	0.0001%	359	0.00005%	758
b-cd16/56	8066	0.0010%	358	0.00005%	8424
s-ck-bb	505	0.0001%	358	0.00005%	863
ab-temp	3582	0.0005%	357	0.00005%	3939
p-fviiire	1174	0.0002%	357	0.00005%	1531
s-ebvabg	29344	0.0038%	356	0.00005%	29700
p-hcvnhty	1183	0.0002%	356	0.00005%	1539
s-ebvabg	567	0.0001%	356	0.00005%	923
metam	18379	0.0024%	355	0.00005%	18734
s-viseabm	1046	0.0001%	355	0.00005%	1401
s-ldestre	561	0.0001%	355	0.00005%	916
u-pikre	338	0.0000%	355	0.00005%	693
s-thevule	169	0.0000%	355	0.00005%	524
hdl/kol	304958	0.0394%	354	0.00005%	305312
ly-tbspppd	3306	0.0004%	354	0.00005%	3660
s-stpn12f	243	0.0000%	354	0.00005%	597
s-biol	109	0.0000%	354	0.00005%	463
pf-laktteh	1679	0.0002%	353	0.00005%	2032
s-asiroe	680	0.0001%	353	0.00005%	1033
u-mapga	474	0.0001%	353	0.00005%	827
ab-ahco3vt	447	0.0001%	353	0.00005%	800
s-gpenige	207	0.0000%	352	0.00005%	559
s-heliabg	204	0.0000%	352	0.00005%	556
p-ca12-5	63405	0.0082%	351	0.00005%	63756
ly-cd19	8067	0.0010%	351	0.00005%	8418
ly-cd16/56	8064	0.0010%	351	0.00005%	8415
s-fusmone	429	0.0001%	351	0.00005%	780
koiraige	119	0.0000%	350	0.00005%	469
p-afxariv	983	0.0001%	349	0.00005%	1332
keliakiaseulonta	243	0.0000%	349	0.00005%	592
ly-cd3	8076	0.0010%	348	0.00004%	8424
ly-cd8	8074	0.0010%	348	0.00004%	8422
fp-aldos	4329	0.0006%	348	0.00004%	4677
ly-cd4	8077	0.0010%	347	0.00004%	8424
s-seessie	183	0.0000%	347	0.00004%	530
s-vzvabm	3475	0.0004%	346	0.00004%	3821
p-urea-jd	1598	0.0002%	346	0.00004%	1944
b-geneseq	344	0.0000%	343	0.00004%	687
s-vpene	217	0.0000%	343	0.00004%	560
ly-tbspotb	3318	0.0004%	342	0.00004%	3660
b-ntprobnp	4944	0.0006%	341	0.00004%	5285
s-urtikar	110	0.0000%	341	0.00004%	451
du-uraat	861	0.0001%	340	0.00004%	1201
s-parvavi	580	0.0001%	340	0.00004%	920
b-hlatrb	132	0.0000%	340	0.00004%	472
p-urea-ed	1687	0.0002%	339	0.00004%	2026
bm-bpvalm	115	0.0000%	339	0.00004%	454
l-eos(a)	195773	0.0253%	338	0.00004%	196111
koivuige	127	0.0000%	338	0.00004%	465
cp-laktaat	11044	0.0014%	337	0.00004%	11381
ab-gluk	12154	0.0016%	336	0.00004%	12490
ly-cd4-t	10794	0.0014%	336	0.00004%	11130
s-17hprog	6322	0.0008%	335	0.00004%	6657
tnlpika	779	0.0001%	335	0.00004%	1114
p-ohbut	634	0.0001%	335	0.00004%	969
ab-ph-vt	516	0.0001%	335	0.00004%	851
s-hivab+tod	313	0.0000%	334	0.00004%	647
s-infaabg	1783	0.0002%	332	0.00004%	2115
pt-ureaind	1572	0.0002%	332	0.00004%	1904
li-laktteh	1550	0.0002%	332	0.00004%	1882
s-katkare	831	0.0001%	332	0.00004%	1163
b-6-me-mp	1602	0.0002%	331	0.00004%	1933
timoteiige	134	0.0000%	331	0.00004%	465
p-inr-pika	21240	0.0027%	330	0.00004%	21570
vb-hkr-vt	261	0.0000%	330	0.00004%	591
p-posturea	3167	0.0004%	329	0.00004%	3496
p-tni.	1828	0.0002%	329	0.00004%	2157
s-aurpule	176	0.0000%	329	0.00004%	505
p-na-vt	17681	0.0023%	328	0.00004%	18009
bl-solut	1531	0.0002%	327	0.00004%	1858
-bentulos	315	0.0000%	327	0.00004%	642
p-vwf-ag	8196	0.0011%	326	0.00004%	8522
s-omenae	1059	0.0001%	325	0.00004%	1384
pt-taksim1	418	0.0001%	325	0.00004%	743
b-hg	336	0.0000%	325	0.00004%	661
b-kllfish	120	0.0000%	325	0.00004%	445
s-adalimu	6790	0.0009%	324	0.00004%	7114
inrpika	3212	0.0004%	324	0.00004%	3536
s-hasspÃ¤e	6777	0.0009%	322	0.00004%	7099
p-aboabg	128	0.0000%	321	0.00004%	449
s-zn	2855	0.0004%	320	0.00004%	3175
arseeni,epÃ¤orgaaninen	910	0.0001%	320	0.00004%	1230
ca++/ph7.4	75025	0.0097%	319	0.00004%	75344
s-parapÃ¤e	4392	0.0006%	319	0.00004%	4711
-amyl	7292	0.0009%	316	0.00004%	7608
s-rapim1e	657	0.0001%	314	0.00004%	971
s-tonnike	547	0.0001%	314	0.00004%	861
s-adenabg	1312	0.0002%	312	0.00004%	1624
s-d2-25	557	0.0001%	312	0.00004%	869
b-trom-s	1779	0.0002%	311	0.00004%	2090
pt-utp-3	107	0.0000%	311	0.00004%	418
vb-shco3	122029	0.0157%	309	0.00004%	122338
b-everoms	1413	0.0002%	308	0.00004%	1721
p-b12-bc	575	0.0001%	307	0.00004%	882
p-nh4-ion	6164	0.0008%	306	0.00004%	6470
s-osacdtr	14079	0.0018%	305	0.00004%	14384
b-ca++-v	538	0.0001%	305	0.00004%	843
c6-indeksi	5879	0.0008%	304	0.00004%	6183
li-igg/alb	5312	0.0007%	304	0.00004%	5616
fs-a-vit	10200	0.0013%	301	0.00004%	10501
p-c-pept	4329	0.0006%	300	0.00004%	4629
f-campjvi	247	0.0000%	300	0.00004%	547
s-karmese	148	0.0000%	300	0.00004%	448
s-codiab	1401	0.0002%	299	0.00004%	1700
s-fibrilla	307	0.0000%	299	0.00004%	606
bm-myelmut	402	0.0001%	298	0.00004%	700
s-acrkile	396	0.0001%	298	0.00004%	694
s-pinp	8448	0.0011%	295	0.00004%	8743
s-ampmyre	1242	0.0002%	295	0.00004%	1537
s-pm-scl	353	0.0000%	292	0.00004%	645
s-rcor14e	323	0.0000%	292	0.00004%	615
s-5hiaa	16724	0.0022%	291	0.00004%	17015
p-aldos	4615	0.0006%	291	0.00004%	4906
p-zn	8843	0.0011%	289	0.00004%	9132
ab-po2(t)	18056	0.0023%	288	0.00004%	18344
p-inrpika	13414	0.0017%	288	0.00004%	13702
b-pyruv	3541	0.0005%	287	0.00004%	3828
tyÃ¶kyky2	1650	0.0002%	287	0.00004%	1937
b-ohbuhoi	919	0.0001%	287	0.00004%	1206
p-glkg	643	0.0001%	287	0.00004%	930
s-pï¿½hk1er	439	0.0001%	287	0.00004%	726
ab-pco2-vt	570	0.0001%	286	0.00004%	856
b-keto	122	0.0000%	286	0.00004%	408
s-echiab	154	0.0000%	285	0.00004%	439
ue-retik	208	0.0000%	283	0.00004%	491
hcgbvkmom*	348	0.0000%	282	0.00004%	630
s-muu-abe	221	0.0000%	282	0.00004%	503
pika-hb	12325	0.0016%	281	0.00004%	12606
fp-ph	6241	0.0008%	281	0.00004%	6522
pf-ly+mono	1324	0.0002%	281	0.00004%	1605
glukpika	11291	0.0015%	280	0.00004%	11571
l-basofiilit	5479	0.0007%	278	0.00004%	5757
vb-o2hb	3533	0.0005%	278	0.00004%	3811
b-ohbutm	2694	0.0003%	278	0.00004%	2972
l-basofiilit	829	0.0001%	278	0.00004%	1107
e-6-tgn	214	0.0000%	278	0.00004%	492
vb-to2c	3478	0.0004%	277	0.00004%	3755
s-gh	1703	0.0002%	277	0.00004%	1980
pd-eryt	1079	0.0001%	277	0.00004%	1356
s-tocaab	227	0.0000%	276	0.00004%	503
s-ch100cl	5646	0.0007%	275	0.00004%	5921
s-hcgbsuh	101	0.0000%	275	0.00004%	376
sy-leukmuu	3914	0.0005%	274	0.00004%	4188
u-gran	1695	0.0002%	274	0.00004%	1969
du-kors-v	7154	0.0009%	272	0.00004%	7426
ns-eosoik	168	0.0000%	272	0.00004%	440
ns-eosvas	168	0.0000%	272	0.00004%	440
ab-ca++	8663	0.0011%	271	0.00003%	8934
u-kreahuu	2814	0.0004%	271	0.00003%	3085
(pikahb)	2211	0.0003%	269	0.00003%	2480
s-kopept	2143	0.0003%	269	0.00003%	2412
munanvalku	734	0.0001%	268	0.00003%	1002
ns-neutoik	168	0.0000%	268	0.00003%	436
ns-neutvas	168	0.0000%	268	0.00003%	436
ab-caionvt	374	0.0000%	266	0.00003%	640
p-fvii	6821	0.0009%	265	0.00003%	7086
s-lehmhie	691	0.0001%	265	0.00003%	956
b-mkvan	582	0.0001%	265	0.00003%	847
s-pennote	147	0.0000%	265	0.00003%	412
u-vÃ¤liepi	2667	0.0003%	263	0.00003%	2930
u-cl	982	0.0001%	263	0.00003%	1245
s-ch100al	5615	0.0007%	262	0.00003%	5877
s-stroab	570	0.0001%	262	0.00003%	832
s-parapek	113	0.0000%	262	0.00003%	375
ub-retik	128	0.0000%	261	0.00003%	389
pt-gluk-2h	12344	0.0016%	260	0.00003%	12604
s-pekpÃ¤he	501	0.0001%	260	0.00003%	761
s-karba	21282	0.0027%	259	0.00003%	21541
fp-folaat	10276	0.0013%	259	0.00003%	10535
s-micfaeg	226	0.0000%	258	0.00003%	484
s-pensppe	729	0.0001%	257	0.00003%	986
s-asat	104490	0.0135%	256	0.00003%	104746
b-probnp	5381	0.0007%	256	0.00003%	5637
hbpika	10273	0.0013%	255	0.00003%	10528
-dmriski	406	0.0001%	254	0.00003%	660
s-trspab	190	0.0000%	254	0.00003%	444
b-kim-fd	174	0.0000%	254	0.00003%	428
s-sakspÃ¤e	5326	0.0007%	253	0.00003%	5579
s-stpn8	344	0.0000%	253	0.00003%	597
b-tp53-d	146	0.0000%	253	0.00003%	399
s-schiaab	582	0.0001%	252	0.00003%	834
s-stpn2	354	0.0000%	252	0.00003%	606
p-gluk2h	2733	0.0004%	251	0.00003%	2984
s-cu	4225	0.0005%	250	0.00003%	4475
s-fascab	598	0.0001%	250	0.00003%	848
s-vilj3er	155	0.0000%	250	0.00003%	405
pt-gfreepi*	6804	0.0009%	249	0.00003%	7053
s-aspfumg	1932	0.0002%	249	0.00003%	2181
pad	1551	0.0002%	248	0.00003%	1799
-mycohe	222	0.0000%	248	0.00003%	470
bor-it-abm	109	0.0000%	248	0.00003%	357
s-pÃ¶lyryh	1289	0.0002%	247	0.00003%	1536
s-schimab	599	0.0001%	247	0.00003%	846
pt-kt/v	5766	0.0007%	246	0.00003%	6012
s-stpn33f	349	0.0000%	246	0.00003%	595
s-heliaba	133	0.0000%	245	0.00003%	378
u-hg	1432	0.0002%	244	0.00003%	1676
du-aldos	3278	0.0004%	242	0.00003%	3520
s-hibab	153	0.0000%	242	0.00003%	395
us-bil	113	0.0000%	242	0.00003%	355
b-bas%	64882	0.0084%	240	0.00003%	65122
fp-insu	6214	0.0008%	240	0.00003%	6454
ly-cd4-8-	553	0.0001%	240	0.00003%	793
s-stpn15b	357	0.0000%	240	0.00003%	597
s-trvirie	322	0.0000%	240	0.00003%	562
s-negadab	110	0.0000%	240	0.00003%	350
cu-aika(s)	3184	0.0004%	239	0.00003%	3423
fs-gastr	3072	0.0004%	238	0.00003%	3310
pt-sik	649	0.0001%	238	0.00003%	887
u-co	1595	0.0002%	236	0.00003%	1831
s-rubeabg	1171	0.0002%	236	0.00003%	1407
s-leptabg	128	0.0000%	236	0.00003%	364
fp-reninm	8525	0.0011%	235	0.00003%	8760
1.savuk	785	0.0001%	235	0.00003%	1020
baso**	128	0.0000%	235	0.00003%	363
nst*	124	0.0000%	235	0.00003%	359
s-cdt%	17508	0.0023%	234	0.00003%	17742
s-ld	41095	0.0053%	232	0.00003%	41327
s-tputree	627	0.0001%	231	0.00003%	858
hoigluk	413	0.0001%	231	0.00003%	644
p-glu/2h	17146	0.0022%	230	0.00003%	17376
-pes.jÃ¤l	6644	0.0009%	230	0.00003%	6874
inr-vt	737	0.0001%	230	0.00003%	967
f-antitry	1807	0.0002%	229	0.00003%	2036
s-infbabg	1200	0.0002%	229	0.00003%	1429
l-ba	319	0.0000%	229	0.00003%	548
-etohgc	174	0.0000%	229	0.00003%	403
p-lh/fsh	1580	0.0002%	228	0.00003%	1808
s-golim	2009	0.0003%	227	0.00003%	2236
b-lcd34	1715	0.0002%	227	0.00003%	1942
p-ige	14562	0.0019%	225	0.00003%	14787
s-karni	1477	0.0002%	225	0.00003%	1702
s-tif1g-o	397	0.0001%	225	0.00003%	622
s-mi-2b-o	397	0.0001%	225	0.00003%	622
s-sae1-o	397	0.0001%	225	0.00003%	622
s-mda5-o	397	0.0001%	225	0.00003%	622
s-mi-2a-o	397	0.0001%	225	0.00003%	622
s-nxp2-o	397	0.0001%	225	0.00003%	622
s-kerulo	11406	0.0015%	224	0.00003%	11630
u-iglck	151	0.0000%	224	0.00003%	375
p-fxiii	5289	0.0007%	223	0.00003%	5512
s-stpn17f	374	0.0000%	223	0.00003%	597
s-fenytv	1564	0.0002%	222	0.00003%	1786
-liik.pr	19948	0.0026%	221	0.00003%	20169
s-appelse	457	0.0001%	221	0.00003%	678
du-sitraat	1551	0.0002%	220	0.00003%	1771
s-porkkae	416	0.0001%	220	0.00003%	636
s-gpene	157	0.0000%	220	0.00003%	377
fs-insu	2385	0.0003%	219	0.00003%	2604
s-htlvjt	171	0.0000%	219	0.00003%	390
ab-o2sat	318285	0.0411%	215	0.00003%	318500
b-cd	656	0.0001%	213	0.00003%	869
b-col/adp	343	0.0000%	213	0.00003%	556
b-vakuly	1494	0.0002%	212	0.00003%	1706
pf-sameus	1431	0.0002%	212	0.00003%	1643
-hcvnhty	274	0.0000%	212	0.00003%	486
as-neut	995	0.0001%	211	0.00003%	1206
s-mansike	540	0.0001%	211	0.00003%	751
pd-mononuk	292	0.0000%	211	0.00003%	503
s-ige2pÃ¶l	6553	0.0008%	210	0.00003%	6763
s-aldos-p	2671	0.0003%	210	0.00003%	2881
testo/shbg	1853	0.0002%	209	0.00003%	2062
p-pctpika	1166	0.0002%	209	0.00003%	1375
s-filaab	206	0.0000%	209	0.00003%	415
bor-it-abg	148	0.0000%	209	0.00003%	357
fp-lipaas	4568	0.0006%	208	0.00003%	4776
s-stpn11a	389	0.0001%	208	0.00003%	597
pt-kons-1	142	0.0000%	208	0.00003%	350
inr-pika	21223	0.0027%	207	0.00003%	21430
s-home1er	245	0.0000%	207	0.00003%	452
s-tria14e	493	0.0001%	206	0.00003%	699
s-stpn10a	391	0.0001%	206	0.00003%	597
fs-lipo(a)	1011	0.0001%	205	0.00003%	1216
c-reaktiivinenproteiini,pika	402	0.0001%	205	0.00003%	607
s-perunae	364	0.0000%	205	0.00003%	569
cb-shco3	65309	0.0084%	204	0.00003%	65513
s-cic	2238	0.0003%	204	0.00003%	2442
s-rmald3e	840	0.0001%	204	0.00003%	1044
bm-mrdpfc	169	0.0000%	204	0.00003%	373
u-iglcl	156	0.0000%	204	0.00003%	360
b-hba/b-d	121	0.0000%	204	0.00003%	325
l-blast	25253	0.0033%	202	0.00003%	25455
fp-tffesat	9872	0.0013%	202	0.00003%	10074
mono**	165	0.0000%	201	0.00003%	366
u-mn	126	0.0000%	201	0.00003%	327
e-fragm	3667	0.0005%	199	0.00003%	3866
askivuosia	1905	0.0002%	199	0.00003%	2104
as-eos	720	0.0001%	199	0.00003%	919
vt-hbsab	365	0.0000%	199	0.00003%	564
s-pajue	228	0.0000%	199	0.00003%	427
p-inrhoi	1433	0.0002%	198	0.00003%	1631
pd-prot	1093	0.0001%	198	0.00003%	1291
c-reaktiivinenproteiini,vieritutkimus	501	0.0001%	198	0.00003%	699
s-rgadc1e	978	0.0001%	197	0.00003%	1175
b-brovmut	449	0.0001%	197	0.00003%	646
b-panel-l	142	0.0000%	197	0.00003%	339
s-evirnho	117	0.0000%	197	0.00003%	314
s-ch100l	5114	0.0007%	196	0.00003%	5310
di-prot	1500	0.0002%	196	0.00003%	1696
-fidd-vt	819	0.0001%	196	0.00003%	1015
pt-fev1	215	0.0000%	196	0.00003%	411
p-cl-vt	198	0.0000%	196	0.00003%	394
s-sakspek	178	0.0000%	196	0.00003%	374
l-cd34	988	0.0001%	195	0.00003%	1183
s-cv19sab	538	0.0001%	195	0.00003%	733
s-sinsime	161	0.0000%	195	0.00003%	356
pu-baktvi2*	146	0.0000%	195	0.00003%	341
cladhee	2602	0.0003%	194	0.00003%	2796
bm-estf-vr	340	0.0000%	194	0.00003%	534
s-ruokryh	690	0.0001%	193	0.00002%	883
keliakiatutkimus,seulonta	351	0.0000%	193	0.00002%	544
u-metseu	215	0.0000%	193	0.00002%	408
u-nitr-0	14359	0.0019%	192	0.00002%	14551
-siitt.	14066	0.0018%	192	0.00002%	14258
p-bil-l	13443	0.0017%	192	0.00002%	13635
s-leptabm	170	0.0000%	192	0.00002%	362
s-borabmv	787	0.0001%	191	0.00002%	978
oma-keto	302	0.0000%	190	0.00002%	492
p-fid-hy	112	0.0000%	190	0.00002%	302
b-ristaus	4530	0.0006%	189	0.00002%	4719
pf-laktaat	2348	0.0003%	189	0.00002%	2537
s-estdio	961	0.0001%	189	0.00002%	1150
s-pistaae	745	0.0001%	189	0.00002%	934
du-5hiaa	2231	0.0003%	188	0.00002%	2419
oma-na	496	0.0001%	188	0.00002%	684
s-osacdt	14725	0.0019%	187	0.00002%	14912
papa	4534	0.0006%	187	0.00002%	4721
oma-k	493	0.0001%	187	0.00002%	680
s-borrabg*	286	0.0000%	187	0.00002%	473
s-paprike	435	0.0001%	186	0.00002%	621
2hgluk	24509	0.0032%	185	0.00002%	24694
-ph	17931	0.0023%	185	0.00002%	18116
ly-tcd4/8.	4998	0.0006%	185	0.00002%	5183
s-insu-ab	829	0.0001%	185	0.00002%	1014
s-hsvabcf	126	0.0000%	185	0.00002%	311
ua-hbo2sat	8322	0.0011%	184	0.00002%	8506
du-vm	2828	0.0004%	184	0.00002%	3012
di-leuk	2828	0.0004%	184	0.00002%	3012
ab-po2-vt	728	0.0001%	184	0.00002%	912
ua-hb	19784	0.0026%	183	0.00002%	19967
s-ige2ruo	5151	0.0007%	183	0.00002%	5334
s-thevulg	357	0.0000%	183	0.00002%	540
s-sertoab	165	0.0000%	183	0.00002%	348
ekg	7027	0.0009%	182	0.00002%	7209
audit-c	1123	0.0001%	182	0.00002%	1305
s-mypn-abg	355	0.0000%	182	0.00002%	537
s-ck-bb%	103	0.0000%	182	0.00002%	285
b-hb-vt	30205	0.0039%	181	0.00002%	30386
s-caionac	17394	0.0022%	181	0.00002%	17575
b-neutr	22073	0.0028%	180	0.00002%	22253
p-kopept	2794	0.0004%	180	0.00002%	2974
s-metad	1566	0.0002%	180	0.00002%	1746
s-afos	205526	0.0265%	179	0.00002%	205705
tyÃ¶kyky	2009	0.0003%	179	0.00002%	2188
s-banaane	536	0.0001%	179	0.00002%	715
s-ckmakr	100	0.0000%	179	0.00002%	279
u-tutk-1,ph	43357	0.0056%	178	0.00002%	43535
fp-trfe-sa	4984	0.0006%	178	0.00002%	5162
tnipika	267	0.0000%	178	0.00002%	445
amp.myrkky	174	0.0000%	178	0.00002%	352
li-/s-alb	3175	0.0004%	177	0.00002%	3352
cp-ohbuthy	525	0.0001%	177	0.00002%	702
p-fsl	6238	0.0008%	176	0.00002%	6414
hoiinr	3090	0.0004%	176	0.00002%	3266
u-leukosyytit	1994	0.0003%	176	0.00002%	2170
s-ovalbue	1651	0.0002%	176	0.00002%	1827
s-na	464656	0.0600%	175	0.00002%	464831
glomerulussuodosnopeus,estimoitu,ckd-epi-kaava	7767	0.0010%	175	0.00002%	7942
s-cladcle	451	0.0001%	175	0.00002%	626
tpoab	197	0.0000%	175	0.00002%	372
luov.seul.	145	0.0000%	175	0.00002%	320
s-kala2er	135	0.0000%	175	0.00002%	310
s-ckmakr%	105	0.0000%	175	0.00002%	280
l-sauva	39076	0.0050%	174	0.00002%	39250
e-fenoty	1115	0.0001%	174	0.00002%	1289
as-amyl	943	0.0001%	174	0.00002%	1117
s-stpn20	163	0.0000%	174	0.00002%	337
p-gluk-po	4917	0.0006%	173	0.00002%	5090
s-ictp	3000	0.0004%	173	0.00002%	3173
du-oksal	2346	0.0003%	173	0.00002%	2519
nlt	23183	0.0030%	172	0.00002%	23355
s-rpena1e	812	0.0001%	172	0.00002%	984
s-lysotse	139	0.0000%	172	0.00002%	311
hb-pika	10972	0.0014%	171	0.00002%	11143
keliakiatutkimus,laaja	1916	0.0002%	171	0.00002%	2087
s-bupre	620	0.0001%	171	0.00002%	791
p-fiddhoi	362	0.0000%	171	0.00002%	533
li-eryt-3	1486	0.0002%	170	0.00002%	1656
mononuk	690	0.0001%	170	0.00002%	860
p-etprom	352	0.0000%	169	0.00002%	521
u-ttca	204	0.0000%	169	0.00002%	373
s-borrab	12624	0.0016%	168	0.00002%	12792
p-tnl	4019	0.0005%	168	0.00002%	4187
p-inr-avh	2167	0.0003%	168	0.00002%	2335
p-dabi-ta	332	0.0000%	168	0.00002%	500
s-aurpulg	314	0.0000%	168	0.00002%	482
p-crpvieri	225	0.0000%	168	0.00002%	393
b-ghba1c	10271	0.0013%	167	0.00002%	10438
li-leuk-3	1491	0.0002%	167	0.00002%	1658
nlt*	199	0.0000%	167	0.00002%	366
ab-t	9260	0.0012%	166	0.00002%	9426
s-afmaksa	6928	0.0009%	166	0.00002%	7094
fp-a-vit	1613	0.0002%	166	0.00002%	1779
s-cv19aba	451	0.0001%	166	0.00002%	617
s-pÃ¤hk1er	448	0.0001%	166	0.00002%	614
s-borrabm*	307	0.0000%	166	0.00002%	473
p-il2r	11738	0.0015%	165	0.00002%	11903
s-olants	10138	0.0013%	165	0.00002%	10303
kilpirauhastutkimus	1553	0.0002%	165	0.00002%	1718
pd-urea	1358	0.0002%	165	0.00002%	1523
saline	3194	0.0004%	164	0.00002%	3358
fp-renin-p	3077	0.0004%	164	0.00002%	3241
fb-nh4-ion	1443	0.0002%	164	0.00002%	1607
c-reaktiivinenproteiini(pikatesti)	406	0.0001%	164	0.00002%	570
d-hbsab	103	0.0000%	164	0.00002%	267
s-afluust	6363	0.0008%	163	0.00002%	6526
p-psa-v*	2141	0.0003%	163	0.00002%	2304
s-koopÃ¤he	1091	0.0001%	163	0.00002%	1254
pf-probnp	210	0.0000%	163	0.00002%	373
s-d-1	14994	0.0019%	162	0.00002%	15156
pf-alb	1480	0.0002%	162	0.00002%	1642
s-ca199ver	1466	0.0002%	162	0.00002%	1628
trop-t	1300	0.0002%	162	0.00002%	1462
b-bnp-v	1138	0.0001%	162	0.00002%	1300
p-tni-p	310	0.0000%	161	0.00002%	471
fb-gluk-o	183	0.0000%	161	0.00002%	344
nst	18327	0.0024%	160	0.00002%	18487
s-afmakro	6346	0.0008%	159	0.00002%	6505
s-tnf	428	0.0001%	159	0.00002%	587
p-ps-agv	14018	0.0018%	158	0.00002%	14176
pt-gfre-3	9212	0.0012%	158	0.00002%	9370
b-vasp	814	0.0001%	158	0.00002%	972
b-myelmut	306	0.0000%	158	0.00002%	464
s-dfarine	256	0.0000%	158	0.00002%	414
s-ananase	161	0.0000%	158	0.00002%	319
b-eosin	51032	0.0066%	157	0.00002%	51189
-pyÃ¶r.s.	6917	0.0009%	157	0.00002%	7074
cu-vm	5014	0.0006%	157	0.00002%	5171
p-insu	1687	0.0002%	157	0.00002%	1844
tst	559	0.0001%	157	0.00002%	716
s-kiivie	532	0.0001%	157	0.00002%	689
cp-glukpot	428	0.0001%	157	0.00002%	585
s-gdomese	423	0.0001%	157	0.00002%	580
s-vzvabcf	156	0.0000%	157	0.00002%	313
s-parvigg	150	0.0000%	157	0.00002%	307
s-sumrisp	417	0.0001%	156	0.00002%	573
b-fidd-v	393	0.0001%	156	0.00002%	549
s-pr3abgk	109	0.0000%	156	0.00002%	265
u-cd	293	0.0000%	155	0.00002%	448
bu-muutsol	136	0.0000%	155	0.00002%	291
s-pitorbe	400	0.0001%	154	0.00002%	554
as-gluk	1813	0.0002%	153	0.00002%	1966
hoib-keto	163	0.0000%	153	0.00002%	316
p-bilneon	5840	0.0008%	152	0.00002%	5992
sprxkoe1	102	0.0000%	152	0.00002%	254
-tilav.	7317	0.0009%	150	0.00002%	7467
prealb	4226	0.0005%	150	0.00002%	4376
sy-gluk	480	0.0001%	150	0.00002%	630
s-testovi	260	0.0000%	150	0.00002%	410
p-prl	30398	0.0039%	149	0.00002%	30547
s-makapÃ¤e	176	0.0000%	149	0.00002%	325
u-bld-o	892	0.0001%	147	0.00002%	1039
b-sirolim	864	0.0001%	147	0.00002%	1011
li-lymf+mo	552	0.0001%	147	0.00002%	699
s-aldos-m	354	0.0000%	146	0.00002%	500
hevonee	2654	0.0003%	145	0.00002%	2799
s-igfbp3	1033	0.0001%	145	0.00002%	1178
p-tt-inrp	363	0.0000%	145	0.00002%	508
as-ly+mono	245	0.0000%	145	0.00002%	390
u-trypg2	210	0.0000%	145	0.00002%	355
s-gluk	2609	0.0003%	143	0.00002%	2752
s-hernee	673	0.0001%	143	0.00002%	816
fs-pcb	244	0.0000%	143	0.00002%	387
p-urarasb	2566	0.0003%	142	0.00002%	2708
s-tsh-peg	2078	0.0003%	142	0.00002%	2220
u-urea	1443	0.0002%	142	0.00002%	1585
p-aboabbm	1044	0.0001%	142	0.00002%	1186
cu-a1migl	865	0.0001%	142	0.00002%	1007
s-hein1er	532	0.0001%	142	0.00002%	674
-stapvi	196	0.0000%	142	0.00002%	338
fp-vip	862	0.0001%	141	0.00002%	1003
s-pensppg	718	0.0001%	141	0.00002%	859
eos*	335	0.0000%	141	0.00002%	476
p-ttr	3590	0.0005%	140	0.00002%	3730
p-troptkon	1182	0.0002%	140	0.00002%	1322
polynuk	689	0.0001%	138	0.00002%	827
ua-ahco3	3324	0.0004%	137	0.00002%	3461
s-kookpÃ¤e	477	0.0001%	137	0.00002%	614
am-mksyn	195	0.0000%	137	0.00002%	332
b-pvk+tkd,ig	116918	0.0151%	136	0.00002%	117054
ns-neutrof	113	0.0000%	136	0.00002%	249
ua-shco3	7701	0.0010%	135	0.00002%	7836
s-tati	4633	0.0006%	135	0.00002%	4768
af-eryt	377	0.0000%	135	0.00002%	512
(b-gluk)	287	0.0000%	135	0.00002%	422
p-aboabbg	248	0.0000%	135	0.00002%	383
fp-c-pept	5534	0.0007%	134	0.00002%	5668
d-cmvabg	133	0.0000%	134	0.00002%	267
s-phadiat	147	0.0000%	133	0.00002%	280
hepyaba	140	0.0000%	133	0.00002%	273
s-flt/pgf	1692	0.0002%	132	0.00002%	1824
s-rvesv5e	1227	0.0002%	132	0.00002%	1359
pt-gfreep	33869	0.0044%	131	0.00002%	34000
ap-lakt	25939	0.0033%	131	0.00002%	26070
pt-gluk-0h	5024	0.0006%	131	0.00002%	5155
dpteroe	2672	0.0003%	131	0.00002%	2803
gluk0	2085	0.0003%	131	0.00002%	2216
p-afxaapi	1514	0.0002%	131	0.00002%	1645
p-fidd*	539	0.0001%	131	0.00002%	670
hepyabg	143	0.0000%	131	0.00002%	274
l-liuska	38581	0.0050%	130	0.00002%	38711
p-hcyst	13728	0.0018%	130	0.00002%	13858
painonmitt	16284	0.0021%	129	0.00002%	16413
s-leppspe	389	0.0001%	129	0.00002%	518
crp(vo.hoitaja)	262	0.0000%	128	0.00002%	390
vb-k	255	0.0000%	128	0.00002%	383
u-rakkoai	6725	0.0009%	127	0.00002%	6852
leuk-pika	4600	0.0006%	127	0.00002%	4727
s-rvesv1e	1119	0.0001%	127	0.00002%	1246
l-bla	37050	0.0048%	126	0.00002%	37176
s-konalbe	597	0.0001%	126	0.00002%	723
p-fakb	508	0.0001%	126	0.00002%	634
s-amitrip	311	0.0000%	126	0.00002%	437
-psa-v%	163	0.0000%	126	0.00002%	289
p-psa-t	124097	0.0160%	125	0.00002%	124222
p-glu/1h	7352	0.0009%	125	0.00002%	7477
sy-polymor	1187	0.0002%	125	0.00002%	1312
s-psa-suh,s-psa-v/t	231	0.0000%	125	0.00002%	356
vp-ph	24660	0.0032%	124	0.00002%	24784
yhdistelty	178	0.0000%	123	0.00002%	301
basof	54901	0.0071%	122	0.00002%	55023
-crp-o	343	0.0000%	122	0.00002%	465
s-rjugr1	114	0.0000%	122	0.00002%	236
s-hsvcf	102	0.0000%	122	0.00002%	224
s-hcgbv	9018	0.0012%	121	0.00002%	9139
sisÃ¤ilmayhteydenotto	895	0.0001%	121	0.00002%	1016
s-kaakaoe	207	0.0000%	121	0.00002%	328
s-ebv-abg	207	0.0000%	121	0.00002%	328
s-bil	50492	0.0065%	120	0.00002%	50612
s-kanie	426	0.0001%	120	0.00002%	546
s-hamsepe	176	0.0000%	120	0.00002%	296
nu-5c-porf	160	0.0000%	120	0.00002%	280
p-k-ses	3891	0.0005%	119	0.00002%	4010
fs-ffa	1045	0.0001%	119	0.00002%	1164
s-rprup3e	796	0.0001%	119	0.00002%	915
af-leuk	515	0.0001%	119	0.00002%	634
u-tubulep	430	0.0001%	119	0.00002%	549
ovomukoidi	282	0.0000%	119	0.00002%	401
s-hcg-a	273	0.0000%	119	0.00002%	392
s-rcypc1e	767	0.0001%	118	0.00002%	885
u-vÃ¤limep	692	0.0001%	118	0.00002%	810
u-cu	136	0.0000%	118	0.00002%	254
kolesteroli.itse	284	0.0000%	117	0.00002%	401
u-jyvlier	140	0.0000%	117	0.00002%	257
pt-arg-r	120	0.0000%	117	0.00002%	237
p-tt.	15192	0.0020%	116	0.00001%	15308
p-urea-de	4792	0.0006%	116	0.00001%	4908
b-ohbutvt	1636	0.0002%	116	0.00001%	1752
b-probnp-o	827	0.0001%	116	0.00001%	943
s-ca19-9v	158	0.0000%	116	0.00001%	274
s-imm-ong	121	0.0000%	116	0.00001%	237
pf-lzm	1419	0.0002%	115	0.00001%	1534
s-hasspek	260	0.0000%	115	0.00001%	375
ts-ngsshs1	216	0.0000%	115	0.00001%	331
pituus	16558	0.0021%	114	0.00001%	16672
paino	1781	0.0002%	113	0.00001%	1894
cb-gluk-0	131	0.0000%	113	0.00001%	244
ab-ca++7.4	9125	0.0012%	112	0.00001%	9237
-s.yht.	7003	0.0009%	112	0.00001%	7115
fl-trihivi	1768	0.0002%	112	0.00001%	1880
s-clteabg	554	0.0001%	112	0.00001%	666
s-niitspe	231	0.0000%	112	0.00001%	343
di-eryt	218	0.0000%	112	0.00001%	330
s-vzvcf	114	0.0000%	112	0.00001%	226
p-fix	4900	0.0006%	111	0.00001%	5011
u-bzd-hy	132	0.0000%	111	0.00001%	243
l-ly%	30432	0.0039%	110	0.00001%	30542
s-d-25-32	7878	0.0010%	110	0.00001%	7988
s-afp/d	1504	0.0002%	110	0.00001%	1614
p-vwfrco	700	0.0001%	110	0.00001%	810
ts-brcamut	309	0.0000%	110	0.00001%	419
s-parpÃ¤he	113	0.0000%	110	0.00001%	223
p-glu/0	17283	0.0022%	109	0.00001%	17392
se-gluk	367	0.0000%	109	0.00001%	476
ab-hbo2svt	317	0.0000%	109	0.00001%	426
s-ca	66865	0.0086%	108	0.00001%	66973
p-at3.	12786	0.0017%	108	0.00001%	12894
pujoe	3065	0.0004%	108	0.00001%	3173
kissae	2696	0.0003%	108	0.00001%	2804
p-fibr.	2620	0.0003%	108	0.00001%	2728
s-cladclg	186	0.0000%	108	0.00001%	294
s-caio7.4	17339	0.0022%	107	0.00001%	17446
s-vedol	2912	0.0004%	107	0.00001%	3019
p-varmtt	2691	0.0003%	107	0.00001%	2798
bm-tcrg-d	1407	0.0002%	107	0.00001%	1514
u-b2miglo	1052	0.0001%	106	0.00001%	1158
lymf**	260	0.0000%	106	0.00001%	366
-neut%	20886	0.0027%	105	0.00001%	20991
s-etane	1272	0.0002%	105	0.00001%	1377
s-cpn-abg	111	0.0000%	105	0.00001%	216
s-scl70-ab	641	0.0001%	104	0.00001%	745
s-nurnate	591	0.0001%	104	0.00001%	695
p-tt-spr	2683	0.0003%	103	0.00001%	2786
pt-ada-ind	1392	0.0002%	103	0.00001%	1495
sy-uraat	241	0.0000%	103	0.00001%	344
tomaatti	192	0.0000%	103	0.00001%	295
fp-pp	112	0.0000%	103	0.00001%	215
p-c-pepta	3992	0.0005%	102	0.00001%	4094
s-usteki	1349	0.0002%	102	0.00001%	1451
-bil	945	0.0001%	102	0.00001%	1047
du-adr	190	0.0000%	102	0.00001%	292
s-rabiab	630	0.0001%	101	0.00001%	731
p-alat.	10698	0.0014%	100	0.00001%	10798
p-na-ses	3538	0.0005%	100	0.00001%	3638
b-cd34	524	0.0001%	100	0.00001%	624
hyytlaus	282	0.0000%	100	0.00001%	382
