	ABBREVIATION	COUNT_NOT_MISSING	PERCENTAGE_NOT_MISSING	COUNT_MISSING	PERCENTAGE_MISSING	COUNT_TOTAL	COUNT_INDVS_NO_MISSING	COUNT_INDVS_MISSING	COUNT_INDVS_ALL
0	b-hkr	32893386	4.2449%	284298	0.03669%	33177684	4046380	156581	4052620
1	b-hb	32620242	4.2097%	273844	0.03534%	32894086	4046423	152973	4052321
2	e-mcv	32442569	4.1867%	378165	0.04880%	32820734	4048098	159460	4054516
3	e-mch	32391249	4.1801%	378049	0.04879%	32769298	4046122	160032	4052577
4	b-eryt	32233249	4.1597%	568138	0.07332%	32801387	4029883	303662	4046216
5	b-leuk	31725206	4.0942%	566703	0.07313%	32291909	4002723	284915	4015748
6	b-trom	31626024	4.0814%	347279	0.04482%	31973303	3985152	162759	3991681
7	e-mchc	23493060	3.0318%	302481	0.03904%	23795541	3135282	106846	3142046
8	p-krea	21797503	2.8130%	297389	0.03838%	22094892	2744337	130140	2752413
9	p-na	21000451	2.7101%	255063	0.03292%	21255514	2811742	129076	2820175
10	p-k	20955616	2.7043%	648097	0.08364%	21603713	2804405	286580	2831547
11	e-rdw	19004745	2.4526%	298963	0.03858%	19303708	2600031	0	2600031
12	p-crp	14796881	1.9095%	4555157	0.58785%	19352038	2141641	1554879	2772444
13	p-alat	12318263	1.5897%	231382	0.02986%	12549645	2608497	114980	2622001
14	pt-gfreepi	8621664	1.1126%	468131	0.06041%	9089795	1348566	0	1348566
15	p-afos	6692309	0.8636%	87173	0.01125%	6779482	1570299	45840	1576311
16	fp-gluk	5764444	0.7439%	54444	0.00703%	5818888	2356871	43932	2365748
17	b-neut	5752671	0.7424%	156194	0.02016%	5908865	1151140	63984	1161638
18	pt-gfre	5011774	0.6468%	44607	0.00576%	5056381	1186099	39460	1201274
19	fp-kol-ldl	4819687	0.6220%	66808	0.00862%	4886495	1886260	52152	1896923
20	b-hba1c	4784590	0.6175%	72445	0.00935%	4857035	1866658	27543	1871431
21	p-tt-inr	4656033	0.6009%	96550	0.01246%	4752583	742629	53839	756368
22	fp-kol	4460728	0.5757%	43727	0.00564%	4504455	1831281	37859	1838746
23	p-tsh	4295934	0.5544%	64316	0.00830%	4360250	1667140	52435	1680373
24	fp-trigly	4291489	0.5538%	45416	0.00586%	4336905	1778003	38819	1786273
25	b-la	4249395	0.5484%	61266	0.00791%	4310661	1669741	43666	1681002
26	fp-kol-hdl	4236675	0.5467%	41487	0.00535%	4278162	1781261	36713	1788932
27	p-gluk	4001677	0.5164%	250431	0.03232%	4252108	1283007	136911	1347358
28	p-bil	3840985	0.4957%	124480	0.01606%	3965465	984482	59950	998462
29	b-eos	3474588	0.4484%	70422	0.00909%	3545010	950193	28215	956874
30	b-baso	3442157	0.4442%	99926	0.01290%	3542083	966271	41085	977627
31	p-t4-v	3106610	0.4009%	44463	0.00574%	3151073	1281284	33267	1289102
32	b-monos	3073307	0.3966%	80191	0.01035%	3153498	883353	33607	891894
33	b-ly	2776535	0.3583%	78498	0.01013%	2855033	792798	44061	803999
34	b-erybla	2587593	0.3339%	57233	0.00739%	2644826	536951	0	536951
35	l-eos	2584061	0.3335%	29673	0.00383%	2613734	685166	10658	688036
36	l-baso	2577250	0.3326%	36650	0.00473%	2613900	677820	13322	682104
37	p-inr	2573886	0.3322%	298088	0.03847%	2871974	285006	0	285006
38	p-gt	2386504	0.3080%	30989	0.00400%	2417493	1103468	22370	1110770
39	p-alb	2369055	0.3057%	60796	0.00785%	2429851	650212	40049	660023
40	fp-krea	2084164	0.2690%	2042	0.00026%	2086206	517211	29348	543630
41	u-ph	2064826	0.2665%	170934	0.02206%	2235760	855267	71715	882477
42	p-asat	1690467	0.2182%	51741	0.00668%	1742208	643984	28103	651292
43	p-tnt	1590569	0.2053%	400090	0.05163%	1990659	508189	254703	701218
44	u-eryt	1573157	0.2030%	56299	0.00727%	1629456	659568	12466	666692
45	u-leuk	1568259	0.2024%	91070	0.01175%	1659329	659854	21736	669754
46	l-neut	1360897	0.1756%	23545	0.00304%	1384442	422024	0	422024
47	s-tsh	1346015	0.1737%	3286	0.00042%	1349301	806060	2698	807677
48	p-amyl	1337244	0.1726%	20388	0.00263%	1357632	629952	14346	634651
49	l-monos	1331897	0.1719%	20903	0.00270%	1352800	399022	0	399022
50	s-alat	1241417	0.1602%	19953	0.00257%	1261370	754819	17258	766016
51	l-lymf(a)	1234319	0.1593%	6984	0.00090%	1241303	296851	0	296851
52	l-neut(a)	1234313	0.1593%	7068	0.00091%	1241381	296844	0	296844
53	l-mono(a)	1233876	0.1592%	7068	0.00091%	1240944	296837	0	296837
54	p-tt	1225925	0.1582%	10764	0.00139%	1236689	432131	9075	435742
55	u-suhti	1194799	0.1542%	158332	0.02043%	1353131	452346	76737	477962
56	fs-trigly	1175915	0.1518%	2682	0.00035%	1178597	739929	2339	741280
57	u-krea	1156647	0.1493%	22434	0.00290%	1179081	465218	12243	469035
58	fs-kol	1140830	0.1472%	3038	0.00039%	1143868	728336	2664	730075
59	fs-kol-hdl	1138106	0.1469%	594	0.00008%	1138700	726667	606	726919
60	fs-kol-ldl	1136346	0.1466%	2048	0.00026%	1138394	726715	2604	728656
61	b-erblast	1075546	0.1388%	253253	0.03268%	1328799	272263	0	272263
62	s-ca-ion	1063028	0.1372%	662317	0.08547%	1725345	393871	265636	636213
63	fs-krea	1049601	0.1355%	496	0.00006%	1050097	698506	533	698736
64	p-ca-iona	1032572	0.1333%	18364	0.00237%	1050936	200415	0	200415
65	ab-po2	1016136	0.1311%	18853	0.00243%	1034989	194952	9498	197857
66	u-lier	1010117	0.1304%	11277	0.00146%	1021394	447005	0	447005
67	p-ck	1002814	0.1294%	13938	0.00180%	1016752	527787	11472	532463
68	ab-pco2	989988	0.1278%	46002	0.00594%	1035990	192501	13386	197808
69	p-cl	978995	0.1263%	2865	0.00037%	981860	185218	1526	185602
70	ab-ph	962279	0.1242%	71408	0.00922%	1033687	187567	21200	196201
71	s-t4-v	949693	0.1226%	8008	0.00103%	957701	582261	6428	585793
72	s-d-25	945906	0.1221%	7765	0.00100%	953671	567897	7059	569891
73	u-leuk-o	918109	0.1185%	1780889	0.22983%	2698998	408121	705079	941484
74	s-ca-iona	892654	0.1152%	32907	0.00425%	925561	314595	0	314595
75	ab-be	890560	0.1149%	156127	0.02015%	1046687	172118	0	172118
76	u-nitr-o	889452	0.1148%	1966202	0.25374%	2855654	430548	703574	1012364
77	p-probnp	879768	0.1135%	29587	0.00382%	909355	375952	22931	390907
78	p-psa	863128	0.1114%	85435	0.01103%	948563	313976	65107	348822
79	u-keto-o	861080	0.1111%	2056554	0.26540%	2917634	434541	661844	996512
80	b-lymf	849263	0.1096%	11595	0.00150%	860858	254934	0	254934
81	p-ferrit	843669	0.1089%	4677	0.00060%	848346	418264	4088	419173
82	s-ph	840522	0.1085%	35902	0.00463%	876424	295517	0	295517
83	p-ca-ion.	829489	0.1070%	17100	0.00221%	846589	164689	0	164689
84	u-epit	819810	0.1058%	39063	0.00504%	858873	387626	0	387626
85	u-gluk-o	812903	0.1049%	2113187	0.27271%	2926090	383972	675682	985157
86	s-gt	812044	0.1048%	2180	0.00028%	814224	587108	2052	588568
87	l-lymf	784758	0.1013%	7506	0.00097%	792264	259350	0	259350
88	p-ca	776968	0.1003%	22281	0.00288%	799249	292148	13127	296739
89	l-ly	769028	0.0992%	16643	0.00215%	785671	242923	0	242923
90	b-pvk+t	761639	0.0983%	15235022	1.96609%	15996661	337107	3143378	3291939
91	p-tni	754139	0.0973%	259620	0.03350%	1013759	259626	153931	368777
92	p-uraat	735087	0.0949%	7643	0.00099%	742730	323502	4361	324876
93	s-crp	702458	0.0907%	637712	0.08230%	1340170	434361	454378	739132
94	u-eryt-o	679372	0.0877%	1086658	0.14023%	1766030	310657	434306	638616
95	s-ferrit	676314	0.0873%	3939	0.00051%	680253	391436	3125	392626
96	u-alb-o	673104	0.0869%	1301803	0.16800%	1974907	324265	397620	623664
97	b-tromb	662459	0.0855%	5641	0.00073%	668100	144750	0	144750
98	ab-hbo2sat	636869	0.0822%	32637	0.00421%	669506	151357	3435	153290
99	p-mg	632964	0.0817%	19319	0.00249%	652283	222049	10509	225899
100	u-alb	622739	0.0804%	265691	0.03429%	888430	272308	136719	346825
101	u-levyep	589433	0.0761%	29217	0.00377%	618650	276333	0	276333
102	ab-hb	582368	0.0752%	61074	0.00788%	643442	96577	0	96577
103	ab-hb-met	580955	0.0750%	2066	0.00027%	583021	85911	0	85911
104	ab-hbo2	572302	0.0739%	726	0.00009%	573028	79648	613	79724
105	u-albkre	571014	0.0737%	335326	0.04327%	906340	251336	194307	367050
106	ab-hb-co	568753	0.0734%	1891	0.00024%	570644	84755	0	84755
107	fb-leuk	551504	0.0712%	4695	0.00061%	556199	139619	0	139619
108	ab-o2-vol%	542554	0.0700%	28364	0.00366%	570918	75022	9153	79211
109	p-ld	529175	0.0683%	7622	0.00098%	536797	156064	5386	157473
110	s-k	525613	0.0678%	588	0.00008%	526201	336055	580	336248
111	s-b12-tc2	509639	0.0658%	261348	0.03373%	770987	378027	201931	528568
112	cb-pco2	502166	0.0648%	25766	0.00333%	527932	167155	15135	172475
113	b-mono	501138	0.0647%	867	0.00011%	502005	126694	0	126694
114	cb-ph	496849	0.0641%	34164	0.00441%	531013	165321	17101	171802
115	fp-pi	495001	0.0639%	8650	0.00112%	503651	137795	6526	139066
116	ab-ahco3	481080	0.0621%	26381	0.00340%	507461	92020	0	92020
117	vb-pco2	475688	0.0614%	17730	0.00229%	493418	178786	9696	183800
118	e-retik	471728	0.0609%	9346	0.00121%	481074	180473	6510	182866
119	u-osmest	469849	0.0606%	11383	0.00147%	481232	197926	0	197926
120		468256	0.0604%	364530	0.04704%	832786	0	0	0
121	s-na	464656	0.0600%	175	0.00002%	464831	308535	172	308613
122	fp-laktaat	463022	0.0598%	2629	0.00034%	465651	98582	2187	99660
123	p-aptt	461142	0.0595%	10294	0.00133%	471436	264470	8941	268854
124	p-hco3	438915	0.0566%	6643	0.00086%	445558	114580	0	114580
125	p-bil-kj	438823	0.0566%	38254	0.00494%	477077	176981	23719	189293
126	s-cdt	438438	0.0566%	11872	0.00153%	450310	284435	10349	290439
127	b-ghb-a1c	436046	0.0563%	147722	0.01906%	583768	227475	0	227475
128	-cv19nho	433585	0.0560%	4931530	0.63642%	5365115	271133	2297239	2422699
129	p-pi	414003	0.0534%	19710	0.00254%	433713	95262	8923	98239
130	u-baktvi	412023	0.0532%	4330522	0.55886%	4742545	217600	1506860	1619936
131	fe-folaat	404708	0.0522%	77054	0.00994%	481762	292724	58888	298933
132	u-suhtih	398023	0.0514%	152669	0.01970%	550692	146973	0	146973
133	u-pienep	394711	0.0509%	24392	0.00315%	419103	203540	0	203540
134	vb-ph	389710	0.0503%	45451	0.00587%	435161	153248	22517	166815
135	s-psa	389208	0.0502%	19390	0.00250%	408598	219986	8543	223522
136	vb-be	385557	0.0498%	106243	0.01371%	491800	150593	0	150593
137	f-calpro	384953	0.0497%	40016	0.00516%	424969	198116	34002	219829
138	cb-be	378548	0.0489%	148289	0.01914%	526837	131603	0	131603
139	u-bakt	377572	0.0487%	881696	0.11378%	1259268	184377	0	184377
140	p-urea	374887	0.0484%	6666	0.00086%	381553	78824	2980	79839
141	p-bnp	374604	0.0483%	16268	0.00210%	390872	143844	12344	150840
142	p-fidd	367703	0.0475%	76660	0.00989%	444363	246809	67412	300912
143	ab-hco3-st	365385	0.0472%	764	0.00010%	366149	48218	0	48218
144	vb-po2	357641	0.0462%	9885	0.00128%	367526	147580	5253	149716
145	u-hb-o	353803	0.0457%	478046	0.06169%	831849	189051	202919	339736
146	pt-lämpöt	352502	0.0455%	745	0.00010%	353247	73032	0	73032
147	vekapak1	352231	0.0455%	416	0.00005%	352647	39348	0	39348
148	u-osmole	349080	0.0450%	29893	0.00386%	378973	178167	0	178167
149	p-tfr	347019	0.0448%	16958	0.00219%	363977	201840	14932	209452
150	u-ph-o	344056	0.0444%	6564	0.00085%	350620	117447	6357	119544
151	p-psa-suh	340555	0.0439%	237254	0.03062%	577809	138391	109905	220074
152	b-na	339965	0.0439%	54293	0.00701%	394258	70944	0	70944
153	s-ca(7.4)	338307	0.0437%	6221	0.00080%	344528	122983	0	122983
154	s-b12-vit	336011	0.0434%	5920	0.00076%	341931	243323	5115	245515
155	fp-pth	333249	0.0430%	3657	0.00047%	336906	110747	2683	111502
156	p-ck-mbm	332766	0.0429%	5877	0.00076%	338643	146066	5235	149517
157	b-k	331214	0.0427%	63125	0.00815%	394339	70768	0	70768
158	b-diffi	330307	0.0426%	1896366	0.24473%	2226673	128665	531165	608324
159	fp-urea	328791	0.0424%	8335	0.00108%	337126	64815	5235	66065
160	p-ca-albk	319292	0.0412%	35933	0.00464%	355225	150411	17200	159735
161	u-prot-o	318326	0.0411%	597310	0.07708%	915636	162322	287678	422117
162	ab-o2sat	318285	0.0411%	215	0.00003%	318500	29619	0	29619
163	kol/hdlsuh	317004	0.0409%	2506	0.00032%	319510	228476	0	228476
164	s-ph(akt)	311482	0.0402%	5847	0.00075%	317329	106642	0	106642
165	s-ca(akt)	311240	0.0402%	5717	0.00074%	316957	106405	0	106405
166	l-mono	305871	0.0395%	2590	0.00033%	308461	95236	0	95236
167	hdl/kol	304958	0.0394%	354	0.00005%	305312	120331	0	120331
168	ph	302232	0.0390%	27713	0.00358%	329945	104022	0	104022
169	b-hb-a1c	292638	0.0378%	1718	0.00022%	294356	189035	60144	247781
170	s-tfr	287452	0.0371%	2000	0.00026%	289452	171286	1758	171933
171	ab-shco3	286534	0.0370%	931	0.00012%	287465	65380	0	65380
172	ap-laktaat	283033	0.0365%	1750	0.00023%	284783	58730	0	58730
173	ap-k	279275	0.0360%	1720	0.00022%	280995	62277	0	62277
174	ap-na	278996	0.0360%	1960	0.00025%	280956	62209	0	62209
175	fp-fe	277733	0.0358%	2577	0.00033%	280310	141463	2028	142092
176	b-laktteh	273473	0.0353%	48237	0.00623%	321710	56969	0	56969
177	lymf	272789	0.0352%	1017	0.00013%	273806	78913	0	78913
178	fs-folaat	269134	0.0347%	6381	0.00082%	275515	215742	6030	218744
179	cb-hco3-st	266753	0.0344%	7145	0.00092%	273898	82741	0	82741
180	baso	265452	0.0343%	1062	0.00014%	266514	76712	0	76712
181	u-kemseul	263008	0.0339%	3640352	0.46979%	3903360	166385	1466567	1567170
182	fp-ca	262359	0.0339%	4130	0.00053%	266489	143572	3586	144969
183	fp-transf	260402	0.0336%	4386	0.00057%	264788	131340	3491	132577
184	ab-thb	257729	0.0333%	1591	0.00021%	259320	53451	0	53451
185	u-solut	257054	0.0332%	1625183	0.20973%	1882237	128561	482289	603218
186	u-baktjvi	254425	0.0328%	1165419	0.15040%	1419844	130782	513115	578708
187	p-amylp	253776	0.0327%	3832	0.00049%	257608	124138	2955	126270
188	u-lieriöt	252730	0.0326%	4805	0.00062%	257535	105383	0	105383
189	p-psa-v	252675	0.0326%	38658	0.00499%	291333	113567	21672	126113
190	p-kol-ldl	249612	0.0322%	1811	0.00023%	251423	173390	1752	174060
191	s-prot	247579	0.0320%	4182	0.00054%	251761	103437	3143	104696
192	ab-ca-i7.4	247277	0.0319%	20363	0.00263%	267640	43504	0	43504
193	u-leuk-bv	246301	0.0318%	8489	0.00110%	254790	84288	0	84288
194	s-ttgaba	244898	0.0316%	325639	0.04202%	570537	208917	278755	471549
195	cb-po2	244859	0.0316%	13444	0.00173%	258303	83713	5980	87081
196	b-hb-co	244784	0.0316%	55291	0.00714%	300075	58275	9241	64364
197	neut	242753	0.0313%	810	0.00010%	243563	76239	0	76239
198	s-cea	240850	0.0311%	35319	0.00456%	276169	89827	19509	100955
199	eos	237731	0.0307%	950	0.00012%	238681	74465	0	74465
200	b-hb-met	236001	0.0305%	56822	0.00733%	292823	54500	9292	61135
201	rakkoaika	231165	0.0298%	17798	0.00230%	248963	103547	0	103547
202	b-eos_	227602	0.0294%	18501	0.00239%	246103	83800	0	83800
203	s-testo	227313	0.0293%	3734	0.00048%	231047	130828	3210	132223
204	b-cl	226271	0.0292%	36122	0.00466%	262393	39823	0	39823
205	vb-hbo2sat	225909	0.0292%	4460	0.00058%	230369	93009	1835	93814
206	b-neut_	224021	0.0289%	15697	0.00203%	239718	83644	0	83644
207	b-retik	222334	0.0287%	43001	0.00555%	265335	107875	19155	109222
208	b-ph	221293	0.0286%	8238	0.00106%	229531	69708	0	69708
209	ca++/7.40	220012	0.0284%	14927	0.00193%	234939	74406	0	74406
210	ca-ion	218073	0.0281%	19485	0.00251%	237558	74907	0	74907
211	ab-ca-ion	212980	0.0275%	55967	0.00722%	268947	39740	0	39740
212	vb-hco3-st	210675	0.0272%	872	0.00011%	211547	74514	0	74514
213	b-angap	206431	0.0266%	55824	0.00720%	262255	36944	0	36944
214	s-afos	205526	0.0265%	179	0.00002%	205705	156498	144	156593
215	p-kol	204957	0.0264%	1281	0.00017%	206238	141464	1228	142075
216	l-eos(a)	195773	0.0253%	338	0.00004%	196111	81112	0	81112
217	l-baso(a)	195696	0.0253%	368	0.00005%	196064	81111	0	81111
218	s-iga	194571	0.0251%	3478	0.00045%	198049	168551	2838	170412
219	s-vrab-o	193845	0.0250%	505465	0.06523%	699310	109457	493111	572833
220	cp-crp-hy	192742	0.0249%	93719	0.01209%	286461	79174	0	79174
221	vb-hb-co	191222	0.0247%	2583	0.00033%	193805	81377	0	81377
222	u-hyalie	190761	0.0246%	4935	0.00064%	195696	71488	0	71488
223	b-baktvi	190376	0.0246%	1480340	0.19104%	1670716	68511	494125	534630
224	s-ca-i7.4	190297	0.0246%	14574	0.00188%	204871	81591	0	81591
225	p-b12-vit	188056	0.0243%	379	0.00005%	188435	133382	742	133627
226	b-po2	186351	0.0240%	7876	0.00102%	194227	58328	0	58328
227	b-pco2	186123	0.0240%	7928	0.00102%	194051	58296	0	58296
228	p-kol-hdl	185944	0.0240%	1335	0.00017%	187279	131742	1296	132339
229	l-liuskat	185078	0.0239%	1757	0.00023%	186835	55726	0	55726
230	s-prealb	182138	0.0235%	1298	0.00017%	183436	89453	988	89848
231	vb-hb-met	181951	0.0235%	2365	0.00031%	184316	78330	0	78330
232	mono	176377	0.0228%	962	0.00012%	177339	60170	0	60170
233	fp-trfesat	171985	0.0222%	1432	0.00018%	173417	84299	0	84299
234	p-t3-v	171558	0.0221%	3065	0.00040%	174623	60305	2257	60987
235	s-ccpab	170343	0.0220%	124245	0.01603%	294588	149713	112073	252781
236	b-liuskat	166367	0.0215%	1901	0.00025%	168268	52855	0	52855
237	l-basof	165252	0.0213%	718	0.00009%	165970	51667	0	51667
238	p-trigly	164916	0.0213%	1123	0.00014%	166039	125435	1280	126216
239	l-lymfos	162962	0.0210%	680	0.00009%	163642	50285	0	50285
240	vb-thb	162211	0.0209%	2261	0.00029%	164472	66655	0	66655
241	p-iga	161135	0.0208%	3532	0.00046%	164667	125723	3286	127785
242	l-neut%	158855	0.0205%	1455	0.00019%	160310	40895	0	40895
243	s-psa-t	157953	0.0204%	17668	0.00228%	175621	54302	0	54302
244	l-eos%	156800	0.0202%	1122	0.00014%	157922	42383	0	42383
245	p-igg	156629	0.0202%	4350	0.00056%	160979	71962	3640	73695
246	ca++	155480	0.0201%	1423	0.00018%	156903	55792	0	55792
247	ca++ph7.4	154903	0.0200%	1902	0.00025%	156805	55725	0	55725
248	pt-gfre-md	154532	0.0199%	231362	0.02986%	385894	75211	87023	154196
249	l-lymf%	154529	0.0199%	1381	0.00018%	155910	39806	0	39806
250	cp-gluk-lb	153180	0.0198%	3485	0.00045%	156665	10061	0	10061
251	s-ige	149759	0.0193%	4906	0.00063%	154665	126536	4355	130015
252	p-d-25	149611	0.0193%	805	0.00010%	150416	104882	318	104963
253	fs-ph	146537	0.0189%	60788	0.00784%	207325	55959	0	55959
254	l-eosin	145398	0.0188%	674	0.00009%	146072	45836	0	45836
255	b-be	142945	0.0184%	50568	0.00653%	193513	45952	0	45952
256	l-neutr	142941	0.0184%	708	0.00009%	143649	44200	0	44200
257	p-gfreepi	141459	0.0183%	331061	0.04272%	472520	17891	0	17891
258	s-korsol	131034	0.0169%	4615	0.00060%	135649	80192	3706	81859
259	fs-gluk	130796	0.0169%	709	0.00009%	131505	93580	1047	94518
260	b-xkoe	130293	0.0168%	1065831	0.13755%	1196124	85543	577260	639144
261	fp-ca-ion.	127820	0.0165%	1091	0.00014%	128911	23469	0	23469
262	e-vrtark	127470	0.0165%	518290	0.06689%	645760	84014	0	84014
263	fs-fe	127102	0.0164%	1920	0.00025%	129022	75683	1441	76206
264	b-eos%	125584	0.0162%	1535	0.00020%	127119	66659	0	66659
265	p-psa-t	124097	0.0160%	125	0.00002%	124222	33006	0	33006
266	p-laktaat	123379	0.0159%	385	0.00005%	123764	47502	0	47502
267	u-epi	122598	0.0158%	2709	0.00035%	125307	45721	0	45721
268	pt-ekg-12	122484	0.0158%	3329759	0.42971%	3452243	86061	1423624	1483311
269	vb-shco3	122029	0.0157%	309	0.00004%	122338	44409	0	44409
270	us-tsh	121566	0.0157%	9167	0.00118%	130733	121545	9173	130492
271	fs-ca-ion	117087	0.0151%	127990	0.01652%	245077	50374	0	50374
272	p-kysc	116919	0.0151%	2168	0.00028%	119087	33795	987	34016
273	b-pvk+tkd,ig	116918	0.0151%	136	0.00002%	117054	9480	0	9480
274	cb-hco3	115687	0.0149%	1454	0.00019%	117141	46215	0	46215
275	ps-strvi	112284	0.0145%	842930	0.10878%	955214	86400	601224	666211
276	vb-hb	110201	0.0142%	15637	0.00202%	125838	49080	0	49080
277	s-fsh	107751	0.0139%	3954	0.00051%	111705	85276	3298	87057
278	-h-ind	107726	0.0139%	53982	0.00697%	161708	37855	0	37855
279	psa-v/psa	107626	0.0139%	2527	0.00033%	110153	61613	0	61613
280	s-prl	107550	0.0139%	1660	0.00021%	109210	74099	1338	74587
281	p-korsol	107166	0.0138%	2547	0.00033%	109713	61332	1532	61736
282	vb-ahco3	107002	0.0138%	10031	0.00129%	117033	44531	0	44531
283	u-osmoest	106913	0.0138%	5372	0.00069%	112285	42592	0	42592
284	p-myogl	105575	0.0136%	2742	0.00035%	108317	49495	2171	50898
285	s-iglck-v	105544	0.0136%	5156	0.00067%	110700	31869	2150	33098
286	cb-hbo2sat	105313	0.0136%	1613	0.00021%	106926	44282	1360	44711
287	s-valpr	105031	0.0136%	1860	0.00024%	106891	29987	1338	30356
288	s-asat	104490	0.0135%	256	0.00003%	104746	78655	232	78841
289	s-iglcl-v	102413	0.0132%	8197	0.00106%	110610	30437	4341	33670
290	s-ca12-5	102112	0.0132%	2211	0.00029%	104323	46644	1576	47485
291	s-ca19-9	100398	0.0130%	14869	0.00192%	115267	42270	8616	47672
292	p-antifxa	99970	0.0129%	27408	0.00354%	127378	34727	15870	43483
293	s-pappa	99914	0.0129%	1189	0.00015%	101103	79230	1180	79761
294	s-k/l-s-v	99147	0.0128%	8093	0.00104%	107240	29291	0	29291
295	p-crphoi	98243	0.0127%	73170	0.00944%	171413	52633	0	52633
296	fp-nh4-ion	97346	0.0126%	5641	0.00073%	102987	41388	4709	43985
297	u-suhti-o	96843	0.0125%	3781	0.00049%	100624	39185	0	39185
298	fp-lipidit	94445	0.0122%	920878	0.11884%	1015323	64804	460025	519359
299	ab-hco3	93855	0.0121%	1875	0.00024%	95730	44574	0	44574
300	s-van	93359	0.0120%	9250	0.00119%	102609	18022	3661	19160
301	p-fibr	92407	0.0119%	3552	0.00046%	95959	38832	2151	39836
302	fs-ace	92385	0.0119%	3934	0.00051%	96319	53330	2961	55293
303	fs-transf	91848	0.0119%	1866	0.00024%	93714	56389	1335	56856
304	p-crp-o	90762	0.0117%	50575	0.00653%	141337	58650	0	58650
305	s-hivagab	90489	0.0117%	510427	0.06587%	600916	70243	324360	378036
306	s-klotsa	89841	0.0116%	9693	0.00125%	99534	10466	1927	10549
307	fs-ca++7.4	89263	0.0115%	594	0.00008%	89857	33553	0	33553
308	p-cea	87290	0.0113%	16988	0.00219%	104278	32601	9337	38682
309	p-pct	86879	0.0112%	3925	0.00051%	90804	46661	1017	47238
310	s-igg	86682	0.0112%	4853	0.00063%	91535	48720	3048	50584
311	p-igm	86671	0.0112%	2331	0.00030%	89002	56458	2222	57898
312	crp-pika	86158	0.0111%	27614	0.00356%	113772	35905	0	35905
313	p-trombai	86137	0.0111%	7886	0.00102%	94023	43292	6982	49481
314	s-rf	85619	0.0110%	63014	0.00813%	148633	78502	97045	171219
315	u-veri-o	84963	0.0110%	180417	0.02328%	265380	35813	31303	63678
316	pu-baktvi1	83035	0.0107%	370651	0.04783%	453686	51302	217529	251422
317	p-crp-hy	82674	0.0107%	65403	0.00844%	148077	46560	0	46560
318	p-at3	80487	0.0104%	922	0.00012%	81409	31942	754	32339
319	u-prot	80350	0.0104%	69380	0.00895%	149730	30107	26548	51806
320	s-shbg	79421	0.0102%	547	0.00007%	79968	53554	487	53773
321	s-ana	77416	0.0100%	174067	0.02246%	251483	61079	157024	209333
322	oma-crp	76145	0.0098%	104189	0.01345%	180334	34745	0	34745
323	vb-o2-sis	75826	0.0098%	2700	0.00035%	78526	33541	734	33688
324	s-digoks	75556	0.0098%	1447	0.00019%	77003	30131	1229	30439
325	ca++/ph7.4	75025	0.0097%	319	0.00004%	75344	28178	0	28178
326	s-psa-v	74763	0.0096%	134210	0.01732%	208973	41606	100056	136522
327	pu-baktvi2	74209	0.0096%	302548	0.03904%	376757	51524	207272	245259
328	u-albkrea	72816	0.0094%	50135	0.00647%	122951	37930	0	37930
329	s-mkomp-1	71466	0.0092%	4964	0.00064%	76430	30401	0	30401
330	p-fviii.	71131	0.0092%	2003	0.00026%	73134	30766	0	30766
331	e-aborh	70671	0.0091%	629058	0.08118%	699729	63301	518153	574683
332	s-tpoab	70363	0.0091%	43689	0.00564%	114052	61350	41349	100374
333	s-t3-v	70333	0.0091%	2859	0.00037%	73192	35522	1547	36057
334	s-gamma	69894	0.0090%	1352	0.00017%	71246	31673	0	31673
335	u-alb-mi	69875	0.0090%	27985	0.00361%	97860	29350	0	29350
336	cb-ahco3	69540	0.0090%	8175	0.00105%	77715	24924	0	24924
337	l-promyel	69126	0.0089%	152475	0.01968%	221601	26934	0	26934
338	p-hcg	69092	0.0089%	47097	0.00608%	116189	33423	18823	50014
339	s-mkomp-2	68768	0.0089%	2442	0.00032%	71210	29733	0	29733
340	s-psa-suh	68650	0.0089%	377907	0.04877%	446557	43213	172041	203526
341	s-lzm	67597	0.0087%	1508	0.00019%	69105	38500	1401	39290
342	s-li	67268	0.0087%	1687	0.00022%	68955	9771	1008	9820
343	s-ca	66865	0.0086%	108	0.00001%	66973	56713	84	56783
344	b-crpp	66205	0.0085%	52663	0.00680%	118868	45738	0	45738
345	b-cya-ms	66196	0.0085%	1494	0.00019%	67690	3414	0	3414
346	s-alfa-1	66166	0.0085%	2033	0.00026%	68199	29527	0	29527
347	s-alfa-2	66021	0.0085%	2075	0.00027%	68096	29393	0	29393
348	s-beta-1	65587	0.0085%	1844	0.00024%	67431	28895	0	28895
349	s-beta-2	65498	0.0085%	1869	0.00024%	67367	28827	0	28827
350	cb-shco3	65309	0.0084%	204	0.00003%	65513	20549	0	20549
351	cb-ca-ion	65072	0.0084%	14609	0.00189%	79681	23918	0	23918
352	-trfesat	64976	0.0084%	4201	0.00054%	69177	38649	3811	39922
353	l-myelos	64916	0.0084%	152386	0.01967%	217302	24795	0	24795
354	b-bas%	64882	0.0084%	240	0.00003%	65122	50623	0	50623
355	s-alb	64611	0.0083%	1503	0.00019%	66114	49986	601	50498
356	p-ca12-5	63405	0.0082%	351	0.00005%	63756	27625	235	27718
357	b-cya	62628	0.0081%	6979	0.00090%	69607	3966	2130	4378
358	s-psa-v/t	62369	0.0080%	9026	0.00116%	71395	25899	0	25899
359	u-chtrnho	61903	0.0080%	467522	0.06033%	529425	47847	307251	340615
360	p-ca-ion	61504	0.0079%	204102	0.02634%	265606	36544	91193	125630
361	p-k-veka	61255	0.0079%	1475	0.00019%	62730	28687	0	28687
362	b-crp-vt	61252	0.0079%	38629	0.00499%	99881	28192	0	28192
363	p-na-veka	61251	0.0079%	1463	0.00019%	62714	28686	0	28686
364	s-pölyer	61137	0.0079%	15699	0.00203%	76836	57175	0	57175
365	muut	60911	0.0079%	424	0.00005%	61335	48748	0	48748
366	b-tacro	60655	0.0078%	5214	0.00067%	65869	2957	1311	3020
367	s-lh	60649	0.0078%	5047	0.00065%	65696	44883	4229	47588
368	s-album	60512	0.0078%	1793	0.00023%	62305	25966	0	25966
369	-chtrnho	60148	0.0078%	267661	0.03454%	327809	44291	171680	204435
370	b-baso%	59775	0.0077%	1481	0.00019%	61256	15477	0	15477
371	l-baso%	59764	0.0077%	1078	0.00014%	60842	20050	0	20050
372	s-afp	58419	0.0075%	8139	0.00105%	66558	25217	5042	28392
373	s-mkomp-3	58364	0.0075%	2306	0.00030%	60670	24568	0	24568
374	s-mkomp-4	58220	0.0075%	2255	0.00029%	60475	24479	0	24479
375	b-thb	58211	0.0075%	2640	0.00034%	60851	28797	0	28797
376	li-prot	58098	0.0075%	2085	0.00027%	60183	44846	1856	46010
377	l-mono%	58054	0.0075%	1250	0.00016%	59304	18493	0	18493
378	u-ctgcnho	57959	0.0075%	381053	0.04918%	439012	46653	288775	323789
379	p-crp-vt	57902	0.0075%	37133	0.00479%	95035	35406	0	35406
380	li-eryt	57814	0.0075%	1453	0.00019%	59267	39206	1275	39999
381	du-prot	57799	0.0075%	9723	0.00125%	67522	25257	5472	27172
382	l-myel	55643	0.0072%	632	0.00008%	56275	20984	0	20984
383	s-mypnabg	55423	0.0072%	27782	0.00359%	83205	46354	26601	71739
384	cp-gluk-hy	55128	0.0071%	47842	0.00617%	102970	11911	0	11911
385	p-inr-vt	55034	0.0071%	10912	0.00141%	65946	14485	0	14485
386	non-hdl	54914	0.0071%	1595	0.00021%	56509	53082	0	53082
387	basof	54901	0.0071%	122	0.00002%	55023	45211	0	45211
388	p-prealb	54885	0.0071%	787	0.00010%	55672	32812	691	32990
389	ts-pad-1	54537	0.0070%	793883	0.10245%	848420	46398	584341	616825
390	fs-trfesat	54435	0.0070%	1786	0.00023%	56221	30779	0	30779
391	li-leuk	54425	0.0070%	3421	0.00044%	57846	38056	2673	40021
392	s-hcg-b-v	54298	0.0070%	6229	0.00080%	60527	40217	1763	41447
393	s-dmklots	54185	0.0070%	3025	0.00039%	57210	6521	1535	6700
394	s-ca15-3	53327	0.0069%	1346	0.00017%	54673	18311	979	18681
395	s-testovl	53326	0.0069%	3739	0.00048%	57065	35924	719	36026
396	e-rdw	53211	0.0069%	298963	0.03858%	352174	2600031	0	2600031
397	pika-crp	52884	0.0068%	27293	0.00352%	80177	21983	0	21983
398	cp-gluk	52785	0.0068%	2455	0.00032%	55240	8468	0	8468
399	p-ca19-9	51941	0.0067%	3422	0.00044%	55363	22321	1836	23845
400	-poccv19	51701	0.0067%	19698	0.00254%	71399	39571	0	39571
401	s-igm	51649	0.0067%	2232	0.00029%	53881	34737	1777	35899
402	s-hbsag	51265	0.0066%	360174	0.04648%	411439	41899	241038	274849
403	vp-na	51062	0.0066%	1856	0.00024%	52918	25625	0	25625
404	vp-k	51045	0.0066%	1872	0.00024%	52917	25622	0	25622
405	b-eosin	51032	0.0066%	157	0.00002%	51189	22937	0	22937
406	vp-cl	50833	0.0066%	1832	0.00024%	52665	25462	0	25462
407	vp-laktaat	50827	0.0066%	1859	0.00024%	52686	25474	0	25474
408	vp-gluk	50825	0.0066%	1843	0.00024%	52668	25460	0	25460
409	s-bil	50492	0.0065%	120	0.00002%	50612	41331	168	41460
410	p-bil-lap	50408	0.0065%	1091	0.00014%	51499	15147	0	15147
411	vp-ca-ion	50293	0.0065%	1836	0.00024%	52129	24918	0	24918
412	fs-lipidit	49576	0.0064%	426643	0.05506%	476219	35973	305910	338171
413	p-hcg-tot	49362	0.0064%	17890	0.00231%	67252	24104	1583	25494
414	cb-laktaat	48761	0.0063%	1819	0.00023%	50580	28589	0	28589
415	li-gluk	48255	0.0062%	2992	0.00039%	51247	39377	2654	41285
416	l-blastit	47988	0.0062%	152331	0.01966%	200319	18257	0	18257
417	s-hcgbv/d	47884	0.0062%	486	0.00006%	48370	38405	0	38405
418	p-haptog	47666	0.0062%	921	0.00012%	48587	30983	0	30983
419	cb-to2c	47294	0.0061%	1776	0.00023%	49070	26876	0	26876
420	u-gcnho	47237	0.0061%	433757	0.05598%	480994	36701	274544	304074
421	b-mono%	46548	0.0060%	1453	0.00019%	48001	9626	0	9626
422	l-metamye	46111	0.0060%	94069	0.01214%	140180	17219	0	17219
423	sy-leuk	45925	0.0059%	3196	0.00041%	49121	32297	2764	34148
424	ua-pco2	45922	0.0059%	4424	0.00057%	50346	45880	0	45880
425	cb-ca-i7.4	45898	0.0059%	7890	0.00102%	53788	17970	0	17970
426	u-ph-huu	45674	0.0059%	3692	0.00048%	49366	19292	0	19292
427	u-bendi-o	45441	0.0059%	267314	0.03450%	312755	24411	120853	139240
428	cb-o2hb	45399	0.0059%	1670	0.00022%	47069	26114	0	26114
429	-gcnho	45225	0.0058%	184211	0.02377%	229436	33083	137365	164192
430	p-rf	44705	0.0058%	80271	0.01036%	124976	39717	20726	60031
431	s-koivue	44651	0.0058%	30857	0.00398%	75508	38964	20195	58687
432	s-borrabm	44540	0.0057%	81959	0.01058%	126499	37166	72871	107213
433	b-hco3	44227	0.0057%	1847	0.00024%	46074	13393	0	13393
434	ua-ph	44205	0.0057%	6196	0.00080%	50401	44167	0	44167
435	s-hcvab	43970	0.0057%	263812	0.03405%	307782	34179	196458	222924
436	u-lieriö	43613	0.0056%	2423	0.00031%	46036	14749	0	14749
437	u-tutk-1,ph	43357	0.0056%	178	0.00002%	43535	11108	0	11108
438	u-ominp-h	43000	0.0055%	2888	0.00037%	45888	18439	0	18439
439	ua-po2	42400	0.0055%	4291	0.00055%	46691	42364	0	42364
440	p-fidd-o	42329	0.0055%	7710	0.00099%	50039	36981	8363	44748
441	s-hcg	42205	0.0054%	66449	0.00858%	108654	22806	45221	62081
442	s-tshrefl	41981	0.0054%	5994	0.00077%	47975	31691	0	31691
443	s-ld	41095	0.0053%	232	0.00003%	41327	14519	164	14546
444	p-etoh	41092	0.0053%	23812	0.00307%	64904	27706	20281	45384
445	s-hbsab	40675	0.0052%	23424	0.00302%	64099	33013	20660	51887
446	b-crp-o	40494	0.0052%	24609	0.00318%	65103	18079	0	18079
447	l-prom	40067	0.0052%	564	0.00007%	40631	15183	0	15183
448	p-gluk-o	39903	0.0051%	7914	0.00102%	47817	14504	0	14504
449	pappakmom	39777	0.0051%	3041	0.00039%	42818	33846	0	33846
450	ntkmom	39775	0.0051%	3043	0.00039%	42818	33846	0	33846
451	s-allige	39560	0.0051%	29685	0.00383%	69245	12116	29048	30516
452	b-tvk	39456	0.0051%	1320570	0.17042%	1360026	27339	431696	453237
453	s-tshrab	39428	0.0051%	24557	0.00317%	63985	21528	20336	37315
454	-ctgcnho	39360	0.0051%	175417	0.02264%	214777	30336	159422	182894
455	hcgbvkmom	39180	0.0051%	2968	0.00038%	42148	33373	0	33373
456	l-sauva	39076	0.0050%	174	0.00002%	39250	14514	0	14514
457	l-liuska	38581	0.0050%	130	0.00002%	38711	14452	0	14452
458	s-timotee	38525	0.0050%	31864	0.00411%	70389	35159	20321	55117
459	l-meta	38456	0.0050%	557	0.00007%	39013	13873	0	13873
460	s-dpteroe	38448	0.0050%	40932	0.00528%	79380	35086	25093	59677
461	ua-hco3-st	37901	0.0049%	394	0.00005%	38295	37875	0	37875
462	fp-kol-ind	37749	0.0049%	517	0.00007%	38266	26917	0	26917
463	p-c3	37544	0.0048%	1159	0.00015%	38703	25889	1066	26582
464	p-c4	37509	0.0048%	1151	0.00015%	38660	25673	1057	26402
465	-nt	37406	0.0048%	2147	0.00028%	39553	31523	0	31523
466	du-ca	37156	0.0048%	5169	0.00067%	42325	22322	3733	23049
467	s-igf1	37114	0.0048%	1034	0.00013%	38148	19374	885	19667
468	l-bla	37050	0.0048%	126	0.00002%	37176	13829	0	13829
469	u-bupre-o	36638	0.0047%	214093	0.02763%	250731	18243	86938	101307
470	s-crp-o	36163	0.0047%	25508	0.00329%	61671	23103	50166	69251
471	b-pvk	35684	0.0046%	2573729	0.33214%	2609413	16111	55169	69350
472	u-gluk-0	35362	0.0046%	10940	0.00141%	46302	8776	0	8776
473	b-hba1cvt	35295	0.0046%	4125	0.00053%	39420	7515	0	7515
474	pt-ekg-atk	34843	0.0045%	547914	0.07071%	582757	22843	222297	238190
475	s-haptog	34745	0.0045%	2703	0.00035%	37448	22797	1911	23868
476	u-canna-o	34526	0.0045%	279195	0.03603%	313721	20450	123424	138672
477	u-osmol	34099	0.0044%	831	0.00011%	34930	26190	721	26439
478	s-caion7.4	34033	0.0044%	513	0.00007%	34546	13718	0	13718
479	pt-gfreep	33869	0.0044%	131	0.00002%	34000	6069	0	6069
480	f-elast1	33771	0.0044%	10531	0.00136%	44302	25409	9546	33788
481	b-inr-pik	33638	0.0043%	431	0.00006%	34069	8726	0	8726
482	fs-c-pept	33584	0.0043%	863	0.00011%	34447	19193	442	19400
483	s-pujoe	33344	0.0043%	35954	0.00464%	69298	30452	23446	53454
484	ps-straag	33134	0.0043%	583690	0.07533%	616824	27178	430093	451812
485	ps-straag	33134	0.0043%	4218	0.00054%	37352	27178	430093	451812
486	b-tacroms	33124	0.0043%	469	0.00006%	33593	2496	0	2496
487	s-hbcab	33035	0.0043%	132331	0.01708%	165366	27573	104166	126880
488	pika-inr	32916	0.0042%	31998	0.00413%	64914	1569	0	1569
489	myel	32814	0.0042%	362	0.00005%	33176	13775	0	13775
490	prom	32705	0.0042%	408	0.00005%	33113	13741	0	13741
491	u-na	32497	0.0042%	7276	0.00094%	39773	23757	5988	28083
492	p-lakveka	32330	0.0042%	597	0.00008%	32927	13057	0	13057
493	p-gluveka	32313	0.0042%	552	0.00007%	32865	13059	0	13059
494	s-e2	32095	0.0041%	6304	0.00081%	38399	23231	5504	27318
495	u-hyalier	31701	0.0041%	1129	0.00015%	32830	15602	0	15602
496	cu-alb-mi	31593	0.0041%	9579	0.00124%	41172	16425	6326	19615
497	s-b12-akt	31456	0.0041%	2982	0.00038%	34438	22512	0	22512
498	s-he4	31445	0.0041%	568	0.00007%	32013	23537	30	23551
499	ts-pad-3	31438	0.0041%	210110	0.02711%	241548	27801	182296	206135
500	crp	31046	0.0040%	21996	0.00284%	53042	17007	0	17007
501	p-ca(7.4)	31027	0.0040%	1320	0.00017%	32347	17655	0	17655
502	u-muulier	30966	0.0040%	1326	0.00017%	32292	15144	0	15144
503	s-trpaab	30887	0.0040%	234749	0.03029%	265636	25942	145995	167952
504	crpvieri	30654	0.0040%	20619	0.00266%	51273	18039	0	18039
505	u-amfet-o	30648	0.0040%	263508	0.03401%	294156	19231	120872	135297
506	b-peth	30639	0.0040%	12774	0.00165%	43413	19971	0	19971
507	l-ly%	30432	0.0039%	110	0.00001%	30542	13453	0	13453
508	p-prl	30398	0.0039%	149	0.00002%	30547	20586	116	20631
509	p-fsh	30302	0.0039%	569	0.00007%	30871	22938	497	23247
510	b-hb-vt	30205	0.0039%	181	0.00002%	30386	17878	0	17878
511	oma-gluk	30157	0.0039%	5045	0.00065%	35202	7191	0	7191
512	s-ebvabg	29344	0.0038%	13544	0.00175%	42888	25877	12228	37116
513	s-ebvabg	29344	0.0038%	356	0.00005%	29700	25877	12228	37116
514	s-nse	29207	0.0038%	563	0.00007%	29770	18324	497	18515
515	cb-hb	28969	0.0037%	5681	0.00073%	34650	15224	0	15224
516	b-pvk+tmd	28912	0.0037%	196522	0.02536%	225434	18560	94241	111990
517	pika-gluk	28800	0.0037%	362	0.00005%	29162	6404	0	6404
518	s-norklot	28704	0.0037%	700	0.00009%	29404	3651	0	3651
519	s-hepyabg	28685	0.0037%	29257	0.00378%	57942	26647	28549	54645
520	s-mypnabm	28563	0.0037%	58638	0.00757%	87201	25365	52034	76287
521	l-neut-m	28523	0.0037%	1121	0.00014%	29644	12375	0	12375
522	s-prot-fr	28272	0.0036%	142302	0.01836%	170574	13141	68942	80037
523	u-ph-hy	28216	0.0036%	9697	0.00125%	37913	18514	0	18514
524	s-chpnabg	28108	0.0036%	15800	0.00204%	43908	25258	14884	39672
525	s-c3	28057	0.0036%	1158	0.00015%	29215	20968	1013	21702
526	s-dgpaba	28010	0.0036%	18268	0.00236%	46278	27087	17232	43900
527	s-borrabg	27818	0.0036%	99084	0.01279%	126902	22759	86817	107298
528	b-retind	27723	0.0036%	4488	0.00058%	32211	14005	0	14005
529	s-c4	27439	0.0035%	1179	0.00015%	28618	20205	1050	21001
530	p-cmvnh	27275	0.0035%	82841	0.01069%	110116	6529	22355	25480
531	e-rethe	27192	0.0035%	559	0.00007%	27751	14761	0	14761
532	oma-p-crp	27150	0.0035%	35720	0.00461%	62870	17829	0	17829
533	s-cmvabg	26942	0.0035%	18269	0.00236%	45211	21002	14232	33647
534	u-opiaa-o	26880	0.0035%	286911	0.03703%	313791	17409	123880	137466
535	s-amh	26764	0.0035%	2115	0.00027%	28879	22067	809	22744
536	f-hhb-o	26662	0.0034%	138526	0.01788%	165188	14691	60877	72338
537	s-cladhee	26645	0.0034%	20810	0.00269%	47455	25083	0	25083
538	b-temp	26504	0.0034%	2085	0.00027%	28589	10034	0	10034
539	-infanho	26430	0.0034%	218534	0.02820%	244964	23744	175144	194401
540	gt-cdt-ind	26324	0.0034%	19209	0.00248%	45533	15292	0	15292
541	s-igg4	26236	0.0034%	4071	0.00053%	30307	18523	3540	21731
542	s-insu	26209	0.0034%	796	0.00010%	27005	9364	458	9557
543	ap-lakt	25939	0.0033%	131	0.00002%	26070	12168	0	12168
544	u-suht-hy	25723	0.0033%	10396	0.00134%	36119	17025	0	17025
545	p-acth	25721	0.0033%	2603	0.00034%	28324	18222	2011	19317
546	s-koirae	25545	0.0033%	13569	0.00175%	39114	23797	0	23797
547	p-inr-hy	25401	0.0033%	3150	0.00041%	28551	1724	0	1724
548	l-blast	25253	0.0033%	202	0.00003%	25455	10073	0	10073
549	s-kissae	25184	0.0033%	13742	0.00177%	38926	23458	0	23458
550	l-eos-m	25101	0.0032%	1400	0.00018%	26501	11202	0	11202
551	l-monos-m	25028	0.0032%	1240	0.00016%	26268	11090	0	11090
552	s-dnanab	24990	0.0032%	37185	0.00480%	62175	16147	30886	42332
553	u-koka-o	24961	0.0032%	266849	0.03444%	291810	15925	110867	123569
554	s-sappih	24682	0.0032%	1542	0.00020%	26224	10866	2180	12524
555	s-kysc	24678	0.0032%	924	0.00012%	25602	10139	552	10358
556	vp-ph	24660	0.0032%	124	0.00002%	24784	6554	0	6554
557	vb-laktaat	24655	0.0032%	869	0.00011%	25524	13785	0	13785
558	vb-temp	24533	0.0032%	805	0.00010%	25338	12628	0	12628
559	2hgluk	24509	0.0032%	185	0.00002%	24694	18723	0	18723
560	l-lymf-m	24389	0.0031%	1058	0.00014%	25447	10701	0	10701
561	näytt.otto	24359	0.0031%	6430	0.00083%	30789	10364	0	10364
562	pf-prot	24277	0.0031%	1801	0.00023%	26078	18061	1559	19097
563	k-pika	24274	0.0031%	538	0.00007%	24812	11833	0	11833
564	na-pika	24213	0.0031%	525	0.00007%	24738	11803	0	11803
565	s-pct	24082	0.0031%	6167	0.00080%	30249	12100	4461	15848
566	s-koirhie	24027	0.0031%	21103	0.00272%	45130	22684	20740	43145
567	b-crp-poc	23953	0.0031%	15382	0.00199%	39335	12882	0	12882
568	vb-he-tase	23933	0.0031%	90226	0.01164%	114159	10085	27896	35066
569	b-crp	23901	0.0031%	7478	0.00097%	31379	10841	0	10841
570	ab-lämpöti	23876	0.0031%	618	0.00008%	24494	12708	0	12708
571	l-baso-m	23768	0.0031%	2164	0.00028%	25932	10575	0	10575
572	fl-strbnho	23712	0.0031%	21363	0.00276%	45075	19505	3110	22609
573	sk-sienvi	23584	0.0030%	106741	0.01378%	130325	21341	95977	112500
574	u-leukla	23531	0.0030%	793	0.00010%	24324	13803	0	13803
575	u-erytla	23527	0.0030%	793	0.00010%	24320	13802	0	13802
576	u-epitla	23526	0.0030%	790	0.00010%	24316	13802	0	13802
577	u-lierla	23509	0.0030%	790	0.00010%	24299	13802	0	13802
578	krea-pika	23444	0.0030%	464	0.00006%	23908	11149	0	11149
579	s-kisshie	23319	0.0030%	21972	0.00284%	45291	22032	21593	43338
580	nlt	23183	0.0030%	172	0.00002%	23355	10400	0	10400
581	vb-gluk	22917	0.0030%	723	0.00009%	23640	12454	0	12454
582	nu-albkrea	22899	0.0030%	4211	0.00054%	27110	17529	0	17529
583	s-ca-albk	22837	0.0029%	3086	0.00040%	25923	20022	2680	22155
584	pt-papa-1	22770	0.0029%	450157	0.05809%	472927	20671	369559	386373
585	s-vzvabg	22513	0.0029%	3489	0.00045%	26002	20672	3280	23676
586	pf-leuk	22430	0.0029%	1466	0.00019%	23896	16593	1232	17377
587	u-metad-o	22205	0.0029%	141321	0.01824%	163526	12489	36911	46635
588	fs-sappih	22152	0.0029%	1495	0.00019%	23647	11664	0	11664
589	s-igakeli	22122	0.0029%	87464	0.01129%	109586	21400	0	21400
590	b-neutr	22073	0.0028%	180	0.00002%	22253	10017	0	10017
591	s-epo	22059	0.0028%	361	0.00005%	22420	18479	344	18705
592	s-hepyaba	22024	0.0028%	15630	0.00202%	37654	20947	15496	36160
593	e-erytbla	22018	0.0028%	2986	0.00039%	25004	9084	0	9084
594	ap-gluk	21755	0.0028%	1370	0.00018%	23125	10288	0	10288
595	s-p�lyer	21726	0.0028%	10590	0.00137%	32316	21140	16136	37119
596	b-t-cd4	21615	0.0028%	1476	0.00019%	23091	10387	0	10387
597	s-normet	21489	0.0028%	363	0.00005%	21852	17905	350	18114
598	-rsvnho	21426	0.0028%	159570	0.02059%	180996	18858	163381	178864
599	s-hevonee	21374	0.0028%	14996	0.00194%	36370	20001	0	20001
600	bla	21326	0.0028%	421	0.00005%	21747	9480	0	9480
601	s-karba	21282	0.0027%	259	0.00003%	21541	8741	199	8813
602	p-inr-pika	21240	0.0027%	330	0.00004%	21570	972	0	972
603	inr-pika	21223	0.0027%	207	0.00003%	21430	879	0	879
604	b-nk	21205	0.0027%	1199	0.00015%	22404	9067	882	9529
605	oma-inr	21199	0.0027%	34093	0.00440%	55292	1308	0	1308
606	s-gt-cdt	21152	0.0027%	2281	0.00029%	23433	10884	0	10884
607	s-ohkarba	21038	0.0027%	1784	0.00023%	22822	9276	937	9468
608	p-ph	21034	0.0027%	441	0.00006%	21475	12989	0	12989
609	ap-ca-ion	20974	0.0027%	1236	0.00016%	22210	9549	0	9549
610	p-pc	20897	0.0027%	551	0.00007%	21448	19561	505	19892
611	-neut%	20886	0.0027%	105	0.00001%	20991	7520	0	7520
612	b-crp-pika	20805	0.0027%	13450	0.00174%	34255	10544	0	10544
613	cb-bil-mi	20681	0.0027%	616	0.00008%	21297	5632	0	5632
614	fp-cga	20672	0.0027%	812	0.00010%	21484	8403	667	8585
615	b-tbifng	20559	0.0027%	30382	0.00392%	50941	18844	24654	42691
616	s-maitoe	20495	0.0026%	21443	0.00277%	41938	17096	12279	29115
617	zb-hbo2sat	20472	0.0026%	7217	0.00093%	27689	2572	0	2572
618	s-hbvpak	20457	0.0026%	34602	0.00447%	55059	18320	0	18320
619	zb-o2-vol%	20435	0.0026%	7207	0.00093%	27642	2570	931	3420
620	s-munavae	20323	0.0026%	23235	0.00300%	43558	16223	14257	30221
621	s-dgpabg	20301	0.0026%	72286	0.00933%	92587	19197	68579	86703
622	s-tygl	20280	0.0026%	19369	0.00250%	39649	5709	5385	8471
623	vb-ca-i7.4	20262	0.0026%	4057	0.00052%	24319	9207	0	9207
624	u-eryt-hy	20256	0.0026%	22218	0.00287%	42474	13301	0	13301
625	-infbnho	20209	0.0026%	181788	0.02346%	201997	17735	129737	144753
626	zb-po2	20063	0.0026%	7207	0.00093%	27270	2525	928	3375
627	zb-pco2	20023	0.0026%	7215	0.00093%	27238	2526	928	3376
628	-liik.pr	19948	0.0026%	221	0.00003%	20169	6898	0	6898
629	ottotapa	19947	0.0026%	272437	0.03516%	292384	13216	0	13216
630	zb-ph	19946	0.0026%	7228	0.00093%	27174	2526	938	3385
631	p-pbnp-lb	19895	0.0026%	1734	0.00022%	21629	9466	0	9466
632	s-osmol	19870	0.0026%	660	0.00009%	20530	13833	474	14067
633	cb-gluk	19816	0.0026%	1081	0.00014%	20897	11474	558	11940
634	ab-laktaat	19806	0.0026%	1071	0.00014%	20877	10965	0	10965
635	ua-hb	19784	0.0026%	183	0.00002%	19967	19781	0	19781
636	cb-tt-inrp	19776	0.0026%	70753	0.00913%	90529	1731	0	1731
637	zb-ahco3	19719	0.0025%	7199	0.00093%	26918	2441	0	2441
638	ab-chb	19663	0.0025%	401	0.00005%	20064	8630	0	8630
639	p-lh	19640	0.0025%	1174	0.00015%	20814	14534	732	14984
640	ts-padcolo	19455	0.0025%	172790	0.02230%	192245	17841	143243	157966
641	oma-hb	19406	0.0025%	7061	0.00091%	26467	9934	0	9934
642	cp-gluk-po	19205	0.0025%	13272	0.00171%	32477	1603	0	1603
643	sy-eryt	19191	0.0025%	5273	0.00068%	24464	13722	4346	17361
644	f-salmvi	18914	0.0024%	141431	0.01825%	160345	13639	115510	127783
645	s-antitry	18833	0.0024%	492	0.00006%	19325	17714	480	18111
646	s-ttgabg	18690	0.0024%	45091	0.00582%	63781	17900	41688	59359
647	cu-alb	18680	0.0024%	14360	0.00185%	33040	11276	8074	14789
648	s-b2miglo	18657	0.0024%	796	0.00010%	19453	10047	391	10193
649	u-leuk-hy	18638	0.0024%	25010	0.00323%	43648	11716	0	11716
650	pikahb	18595	0.0024%	6888	0.00089%	25483	9351	0	9351
651	vb-ca-ion	18591	0.0024%	5668	0.00073%	24259	8366	0	8366
652	f-cldtnho	18387	0.0024%	153304	0.01978%	171691	13592	101814	111559
653	metam	18379	0.0024%	355	0.00005%	18734	8042	0	8042
654	b-cd19	18341	0.0024%	390	0.00005%	18731	6852	0	6852
655	b-cd4	18340	0.0024%	387	0.00005%	18727	6853	0	6853
656	b-cd8	18337	0.0024%	389	0.00005%	18726	6853	0	6853
657	b-cd3	18336	0.0024%	499	0.00006%	18835	6853	0	6853
658	s-hbcabm	18336	0.0024%	11937	0.00154%	30273	16576	10869	26955
659	nst	18327	0.0024%	160	0.00002%	18487	8081	0	8081
660	s-hs-crp	18281	0.0024%	1745	0.00023%	20026	11488	0	11488
661	fb-folaat	18271	0.0024%	473	0.00006%	18744	16007	451	16302
662	u-levyepi	18114	0.0023%	2213	0.00029%	20327	7778	0	7778
663	f-hepyag	18084	0.0023%	101817	0.01314%	119901	15739	88929	102858
664	ab-po2(t)	18056	0.0023%	288	0.00004%	18344	9303	0	9303
665	ab-pco2(t)	17956	0.0023%	413	0.00005%	18369	9243	0	9243
666	s-hevohie	17947	0.0023%	25497	0.00329%	43444	16975	24833	41570
667	ab-ph(t)	17937	0.0023%	459	0.00006%	18396	9211	0	9211
668	-ph	17931	0.0023%	185	0.00002%	18116	13710	0	13710
669	u-leuk-0	17918	0.0023%	9010	0.00116%	26928	6350	0	6350
670	p-vrab-o	17855	0.0023%	1367368	0.17646%	1385223	8482	397481	402397
671	s-maapähe	17732	0.0023%	9707	0.00125%	27439	14981	0	14981
672	s-keliseu	17723	0.0023%	63839	0.00824%	81562	17353	0	17353
673	p-na-vt	17681	0.0023%	328	0.00004%	18009	10268	0	10268
674	p-reninm	17663	0.0023%	622	0.00008%	18285	12682	559	12932
675	s-cdt%	17508	0.0023%	234	0.00003%	17742	9148	0	9148
676	p-crp-hy*	17488	0.0023%	11766	0.00152%	29254	11343	0	11343
677	u-amyl	17456	0.0023%	375	0.00005%	17831	13877	348	14150
678	fs-gh	17446	0.0023%	2144	0.00028%	19590	6522	1467	7513
679	ts-padgast	17445	0.0023%	218699	0.02822%	236144	16466	195958	210399
680	s-mtx	17421	0.0022%	2955	0.00038%	20376	1580	816	1778
681	vb-hco3	17402	0.0022%	1098	0.00014%	18500	11716	0	11716
682	s-caionac	17394	0.0022%	181	0.00002%	17575	8240	0	8240
683	s-caio7.4	17339	0.0022%	107	0.00001%	17446	8229	0	8229
684	u-alb/kre	17332	0.0022%	16058	0.00207%	33390	10026	0	10026
685	p-fv	17311	0.0022%	428	0.00006%	17739	9298	392	9589
686	p-glu/0	17283	0.0022%	109	0.00001%	17392	12566	0	12566
687	pf-eryt	17256	0.0022%	2970	0.00038%	20226	12857	2315	14822
688	s-pr3ab	17208	0.0022%	59999	0.00774%	77207	7413	48407	54615
689	p-glu/2h	17146	0.0022%	230	0.00003%	17376	12506	0	12506
690	l-sauvat	17096	0.0022%	1751	0.00023%	18847	7501	0	7501
691	p-krea-vt	17011	0.0022%	420	0.00005%	17431	9961	0	9961
692	cp-inr-hy	17006	0.0022%	6031	0.00078%	23037	1780	0	1780
693	p-gluk-vt	16738	0.0022%	9083	0.00117%	25821	10810	0	10810
694	s-5hiaa	16724	0.0022%	291	0.00004%	17015	6930	244	7046
695	pt-gluk-r1	16644	0.0021%	177048	0.02285%	193692	10955	136088	146330
696	s-emaba	16641	0.0021%	129459	0.01671%	146100	13709	101320	113046
697	s-bil-kj	16589	0.0021%	1270	0.00016%	17859	13777	1226	14915
698	hoi-crp-pi	16583	0.0021%	11819	0.00153%	28402	8466	0	8466
699	li-laktaat	16579	0.0021%	902	0.00012%	17481	13835	852	14332
700	pituus	16558	0.0021%	114	0.00001%	16672	15981	0	15981
701	b-tnt-o	16535	0.0021%	61431	0.00793%	77966	10141	0	10141
702	b-vrab-gr	16478	0.0021%	143756	0.01855%	160234	12535	85102	97112
703	-mrsavi	16447	0.0021%	470200	0.06068%	486647	7334	172615	178027
704	painonmitt	16284	0.0021%	129	0.00002%	16413	15706	0	15706
705	s-igg1	16275	0.0021%	2970	0.00038%	19245	12976	2501	15250
706	s-metnef	16124	0.0021%	3894	0.00050%	20018	13688	0	13688
707	p-hb	16086	0.0021%	1233	0.00016%	17319	6704	1025	7571
708	p-crp-oma	15999	0.0021%	4939	0.00064%	20938	7147	0	7147
709	s-ruok5er	15966	0.0021%	8996	0.00116%	24962	15335	8799	23925
710	pf-gluk	15929	0.0021%	1654	0.00021%	17583	12551	1442	13577
711	s-ecp	15844	0.0020%	400	0.00005%	16244	11318	365	11515
712	b-rethe	15782	0.0020%	703	0.00009%	16485	6614	0	6614
713	s-igg3	15709	0.0020%	3431	0.00044%	19140	12496	2835	15162
714	s-igg2	15636	0.0020%	3500	0.00045%	19136	12458	2894	15161
715	pf-ld	15568	0.0020%	1322	0.00017%	16890	12281	1181	13066
716	cb-bil	15534	0.0020%	8289	0.00107%	23823	3453	2401	5118
717	b-lakt-d	15518	0.0020%	124663	0.01609%	140181	15088	119079	133851
718	uv-pco2	15514	0.0020%	918	0.00012%	16432	15492	0	15492
719	cp-inr-vt	15510	0.0020%	5746	0.00074%	21256	2995	0	2995
720	ts-pad-4	15442	0.0020%	80665	0.01041%	96107	14176	71769	84715
721	s-dheas	15356	0.0020%	883	0.00011%	16239	12765	762	13350
722	p-tt.	15192	0.0020%	116	0.00001%	15308	13912	0	13912
723	cb-het-ion	15142	0.0020%	114790	0.01481%	129932	4903	30373	33838
724	li-igg	15011	0.0019%	1480	0.00019%	16491	12879	1291	13996
725	b-tt-inrv	14995	0.0019%	373	0.00005%	15368	1020	0	1020
726	s-d-1	14994	0.0019%	162	0.00002%	15156	13003	184	13136
727	p-k-vt	14903	0.0019%	3087	0.00040%	17990	8859	0	8859
728	cb-tt-inr	14879	0.0019%	1218	0.00016%	16097	988	0	988
729	s-osacdt	14725	0.0019%	187	0.00002%	14912	10461	0	10461
730	s-ada	14716	0.0019%	1262	0.00016%	15978	11237	1039	11661
731	zb-be	14606	0.0019%	12790	0.00165%	27396	2378	0	2378
732	oma-p-gluk	14566	0.0019%	15640	0.00202%	30206	5857	0	5857
733	p-ige	14562	0.0019%	225	0.00003%	14787	12780	166	12900
734	sy-solut	14427	0.0019%	23477	0.00303%	37904	10501	17583	27237
735	b-erblas	14376	0.0019%	15437	0.00199%	29813	9599	0	9599
736	neutrofiilit	14359	0.0019%	5234	0.00068%	19593	8520	0	8520
737	u-nitr-0	14359	0.0019%	192	0.00002%	14551	4685	0	4685
738	albumiini	14327	0.0018%	1373	0.00018%	15700	4305	0	4305
739	s-chpnaba	14291	0.0018%	8149	0.00105%	22440	12814	7851	20432
740	u-prot-hy	14246	0.0018%	29135	0.00376%	43381	10129	0	10129
741	p-kardabg	14206	0.0018%	10414	0.00134%	24620	11913	564	12429
742	p-tnt-vt	14202	0.0018%	60150	0.00776%	74352	6921	0	6921
743	u-huumlct	14098	0.0018%	25556	0.00330%	39654	4734	1015	5735
744	s-hcrp	14090	0.0018%	13334	0.00172%	27424	13188	0	13188
745	s-ige-sse	14082	0.0018%	19608	0.00253%	33690	10435	20590	27639
746	s-osacdtr	14079	0.0018%	305	0.00004%	14384	9929	0	9929
747	-siitt.	14066	0.0018%	192	0.00002%	14258	7397	0	7397
748	u-huum-o	14029	0.0018%	175594	0.02266%	189623	9336	84193	91627
749	p-ps-agv	14018	0.0018%	158	0.00002%	14176	12925	116	12954
750	leuk-o	13970	0.0018%	41793	0.00539%	55763	5413	0	5413
751	p-urea-dj	13946	0.0018%	473	0.00006%	14419	1404	0	1404
752	s-chpnabm	13823	0.0018%	29702	0.00383%	43525	12582	27470	39657
753	p-hcyst	13728	0.0018%	130	0.00002%	13858	11265	134	11327
754	u-k	13722	0.0018%	410	0.00005%	14132	10298	322	10452
755	uv-ph	13558	0.0017%	2914	0.00038%	16472	13539	0	13539
756	p-bil-l	13443	0.0017%	192	0.00002%	13635	3770	0	3770
757	li-alb	13425	0.0017%	1279	0.00017%	14704	12570	1107	13502
758	p-inrpika	13414	0.0017%	288	0.00004%	13702	10347	0	10347
759	b-co	13357	0.0017%	1309	0.00017%	14666	8984	1134	9350
760	b-baktjvi	13351	0.0017%	56909	0.00734%	70260	6856	28599	34751
761	s-ruokaer	13337	0.0017%	4509	0.00058%	17846	12537	0	12537
762	s-enaab	12861	0.0017%	56615	0.00731%	69476	11081	49975	60452
763	s-mg-ion	12808	0.0017%	529	0.00007%	13337	5296	0	5296
764	p-crppika	12788	0.0017%	9186	0.00119%	21974	8754	0	8754
765	p-at3.	12786	0.0017%	108	0.00001%	12894	11982	0	11982
766	b-cr	12687	0.0016%	2733	0.00035%	15420	8414	1150	9001
767	p-tnih	12665	0.0016%	2460	0.00032%	15125	6503	0	6503
768	s-borrab	12624	0.0016%	119189	0.01538%	131813	11061	101379	111281
769	s-borrab	12624	0.0016%	168	0.00002%	12792	11061	101379	111281
770	cb-o2-sis	12601	0.0016%	359	0.00005%	12960	7277	5106	11922
771	fs-cga	12597	0.0016%	573	0.00007%	13170	5667	491	5798
772	s-ast	12594	0.0016%	9547	0.00123%	22141	11606	9009	20402
773	p-tpoab	12563	0.0016%	8450	0.00109%	21013	11014	7449	18051
774	b-pvk+tkd	12561	0.0016%	1032257	0.13321%	1044818	7646	255490	260915
775	f-baktvip	12449	0.0016%	43770	0.00565%	56219	10971	0	10971
776	s-prog	12374	0.0016%	805	0.00010%	13179	9720	721	10254
777	pt-gluk-2h	12344	0.0016%	260	0.00003%	12604	9685	0	9685
778	li-igg-ind	12329	0.0016%	4148	0.00054%	16477	11624	3000	13491
779	pika-hb	12325	0.0016%	281	0.00004%	12606	7664	0	7664
780	u-sg	12295	0.0016%	5983	0.00077%	18278	8288	0	8288
781	b-hba1c-p	12274	0.0016%	470	0.00006%	12744	3320	0	3320
782	s-gadab	12266	0.0016%	13917	0.00180%	26183	11444	13192	24271
783	ab-gluk	12154	0.0016%	336	0.00004%	12490	8325	0	8325
784	u-mdma-o	12149	0.0016%	9182	0.00118%	21331	7113	3659	10375
785	p-fidd-lb	12138	0.0016%	504	0.00007%	12642	9351	0	9351
786	s-vlseabm	12081	0.0016%	2357	0.00030%	14438	10175	0	10175
787	u-prokre	12056	0.0016%	4597	0.00059%	16653	3628	1600	3906
788	uv-po2	12041	0.0016%	862	0.00011%	12903	12023	0	12023
789	s-aldos	11985	0.0015%	1301	0.00017%	13286	9871	1097	10692
790	p-vwf-akt	11927	0.0015%	669	0.00009%	12596	7516	498	7704
791	s-äitseul	11774	0.0015%	65313	0.00843%	77087	10848	0	10848
792	p-il2r	11738	0.0015%	165	0.00002%	11903	6201	153	6249
793	pt-gfrekys	11735	0.0015%	1481	0.00019%	13216	3629	0	3629
794	p-crp.	11670	0.0015%	3644	0.00047%	15314	4357	0	4357
795	u-hcg-o	11640	0.0015%	67454	0.00870%	79094	10287	51687	60313
796	s-koivspe	11601	0.0015%	2011	0.00026%	13612	10882	0	10882
797	b-fidd	11588	0.0015%	1228	0.00016%	12816	9143	246	9354
798	vb-vkperus	11583	0.0015%	6311	0.00081%	17894	4280	0	4280
799	pf-ada	11579	0.0015%	1860	0.00024%	13439	9441	1566	10416
800	cp-k	11500	0.0015%	441	0.00006%	11941	4197	0	4197
801	b-inrvieri	11491	0.0015%	4694	0.00061%	16185	610	0	610
802	ts-pad-ih	11472	0.0015%	110260	0.01423%	121732	10178	90414	98554
803	u-kemseul,ph	11406	0.0015%	36770	0.00475%	48176	4903	0	4903
804	s-kerulo	11406	0.0015%	224	0.00003%	11630	10904	219	11072
805	b-b-cd19	11403	0.0015%	893	0.00012%	12296	6035	0	6035
806	cp-na	11390	0.0015%	550	0.00007%	11940	4170	0	4170
807	u-ca	11368	0.0015%	1017	0.00013%	12385	5563	752	5897
808	s-paras	11303	0.0015%	9512	0.00123%	20815	6270	7265	11567
809	virtsam.	11298	0.0015%	368	0.00005%	11666	5849	0	5849
810	glukpika	11291	0.0015%	280	0.00004%	11571	8554	0	8554
811	gamma-glob	11284	0.0015%	674	0.00009%	11958	3511	0	3511
812	u-alb/krea	11251	0.0015%	9562	0.00123%	20813	6432	0	6432
813	ly-t-cd3	11226	0.0014%	904	0.00012%	12130	5988	0	5988
814	cp-ca-ion	11222	0.0014%	519	0.00007%	11741	4082	0	4082
815	ly-nk	11165	0.0014%	897	0.00012%	12062	5980	0	5980
816	hb-o	11135	0.0014%	17250	0.00223%	28385	5022	0	5022
817	b-t-cd8	11107	0.0014%	1083	0.00014%	12190	5960	0	5960
818	pulssi	11067	0.0014%	1776	0.00023%	12843	9812	0	9812
819	b-t-cd3	11055	0.0014%	1029	0.00013%	12084	5961	0	5961
820	cp-laktaat	11044	0.0014%	337	0.00004%	11381	4153	0	4153
821	ly-hlab27	11028	0.0014%	60506	0.00781%	71534	10678	58181	68441
822	s-timospe	11007	0.0014%	2009	0.00026%	13016	10298	0	10298
823	hb-pika	10972	0.0014%	171	0.00002%	11143	6991	0	6991
824	u-syto	10942	0.0014%	81045	0.01046%	91987	6184	46169	50111
825	fb-b1-vit	10919	0.0014%	602	0.00008%	11521	8914	528	9242
826	u-keto-0	10916	0.0014%	12565	0.00162%	23481	4111	0	4111
827	alfa2-glob	10885	0.0014%	775	0.00010%	11660	3436	0	3436
828	s-rnpab	10861	0.0014%	26015	0.00336%	36876	8326	23049	30641
829	ly-cd4-t	10794	0.0014%	336	0.00004%	11130	5368	0	5368
830	p-alat.	10698	0.0014%	100	0.00001%	10798	7691	0	7691
831	p-luakptt	10579	0.0014%	906	0.00012%	11485	9533	883	10300
832	p-tnt-o	10573	0.0014%	32506	0.00419%	43079	7219	73653	79623
833	s-trypt	10557	0.0014%	899	0.00012%	11456	7188	0	7188
834	beta1-glob	10528	0.0014%	960	0.00012%	11488	3277	0	3277
835	s-turskae	10528	0.0014%	21989	0.00284%	32517	9174	14688	23656
836	p-luakrvv	10519	0.0014%	932	0.00012%	11451	9488	5513	14868
837	down-risuh	10518	0.0014%	31163	0.00402%	41681	9805	0	9805
838	s-aldol	10507	0.0014%	1699	0.00022%	12206	7592	1539	8818
839	p-fviii	10497	0.0014%	877	0.00011%	11374	8406	604	8679
840	l-myel-m	10486	0.0014%	1531	0.00020%	12017	4933	0	4933
841	alfa1-glob	10473	0.0014%	1183	0.00015%	11656	3378	0	3378
842	beta2-glob	10470	0.0014%	1189	0.00015%	11659	3390	0	3390
843	b-tnt	10396	0.0013%	14195	0.00183%	24591	4683	0	4683
844	vb-lämpöti	10293	0.0013%	516	0.00007%	10809	8262	0	8262
845	fp-folaat	10276	0.0013%	259	0.00003%	10535	8524	252	8626
846	hbpika	10273	0.0013%	255	0.00003%	10528	7965	0	7965
847	b-ghba1c	10271	0.0013%	167	0.00002%	10438	8026	0	8026
848	cd4	10254	0.0013%	557	0.00007%	10811	3189	0	3189
849	s-siliab	10221	0.0013%	35883	0.00463%	46104	9076	31879	39575
850	fs-a-vit	10200	0.0013%	301	0.00004%	10501	5708	268	5830
851	s-olants	10138	0.0013%	165	0.00002%	10303	5038	135	5079
852	pt-kt/v1	10137	0.0013%	941	0.00012%	11078	1287	0	1287
853	cb-chb	10117	0.0013%	593	0.00008%	10710	3662	0	3662
854	ikäriski	10108	0.0013%	32619	0.00421%	42727	9524	0	9524
855	pika-crp-o	10102	0.0013%	517	0.00007%	10619	4788	0	4788
856	s-mpoabg	10102	0.0013%	30544	0.00394%	40646	6281	23299	28707
857	hoicrp	10050	0.0013%	10631	0.00137%	20681	8288	0	8288
858	du-tilav	10028	0.0013%	488	0.00006%	10516	5952	0	5952
859	s-ssaab	10021	0.0013%	22120	0.00285%	32141	7914	19602	27023
860	p-b2gpabg	9952	0.0013%	13469	0.00174%	23421	8341	891	9175
861	ua-be	9940	0.0013%	40333	0.00521%	50273	9930	0	9930
862	s-etoh	9920	0.0013%	8545	0.00110%	18465	7812	7486	14602
863	tri18risuh	9914	0.0013%	29232	0.00377%	39146	9380	0	9380
864	u-metam-o	9884	0.0013%	51094	0.00659%	60978	5403	5318	10570
865	b-crp-v	9881	0.0013%	5606	0.00072%	15487	5591	0	5591
866	fp-tffesat	9872	0.0013%	202	0.00003%	10074	5035	0	5035
867	s-mypnab	9869	0.0013%	78301	0.01010%	88170	8426	68626	76687
868	s-rarah2e	9823	0.0013%	5669	0.00073%	15492	8086	172	8248
869	-hhpvnho	9816	0.0013%	22927	0.00296%	32743	7273	10001	15182
870	f-baktvi1	9794	0.0013%	126050	0.01627%	135844	8966	111979	120373
871	p-apcres.	9774	0.0013%	706	0.00009%	10480	9138	0	9138
872	as-leuk	9752	0.0013%	507	0.00007%	10259	5393	360	5570
873	cd4/cd8	9743	0.0013%	551	0.00007%	10294	3045	0	3045
874	u-tutkesi	9730	0.0013%	468115	0.06041%	477845	6828	0	6828
875	s-vlseabg	9560	0.0012%	4892	0.00063%	14452	8008	0	8008
876	p-ebvnh	9533	0.0012%	36945	0.00477%	46478	4436	16179	19100
877	s-fenyt	9498	0.0012%	372	0.00005%	9870	3663	142	3711
878	pf-ph	9473	0.0012%	1351	0.00017%	10824	7715	0	7715
879	pt-fvspird	9417	0.0012%	100481	0.01297%	109898	8365	82420	90485
880	s-tsh-abr	9368	0.0012%	3063	0.00040%	12431	4547	0	4547
881	s-pujospe	9324	0.0012%	2732	0.00035%	12056	8876	0	8876
882	l-meta-m	9318	0.0012%	1717	0.00022%	11035	4512	0	4512
883	b-crp-pik	9299	0.0012%	17455	0.00225%	26754	5608	0	5608
884	-baktnho	9288	0.0012%	23356	0.00301%	32644	5849	19158	24090
885	ab-t	9260	0.0012%	166	0.00002%	9426	3270	0	3270
886	pt-gfre-3	9212	0.0012%	158	0.00002%	9370	2966	0	2966
887	ab-ca++7.4	9125	0.0012%	112	0.00001%	9237	6031	0	6031
888	p-hiv1nh	9102	0.0012%	25939	0.00335%	35041	2975	6391	7244
889	crppika	9076	0.0012%	10628	0.00137%	19704	5664	0	5664
890	s-hcgbv	9018	0.0012%	121	0.00002%	9139	7390	0	7390
891	vb-het-ion	8981	0.0012%	44885	0.00579%	53866	5411	27109	31350
892	s-vehnjae	8863	0.0011%	6565	0.00085%	15428	7712	0	7712
893	p-zn	8843	0.0011%	289	0.00004%	9132	6135	304	6281
894	sa-korsol	8778	0.0011%	1139	0.00015%	9917	5786	472	6154
895	p-crp-hoi	8769	0.0011%	3307	0.00043%	12076	2614	0	2614
896	ab-o2hb	8708	0.0011%	692	0.00009%	9400	3183	0	3183
897	ab-k	8705	0.0011%	483	0.00006%	9188	5866	0	5866
898	ab-ca++	8663	0.0011%	271	0.00003%	8934	5950	0	5950
899	s-bopeabg	8594	0.0011%	7906	0.00102%	16500	8067	7776	15635
900	ab-to2c	8559	0.0011%	687	0.00009%	9246	3092	0	3092
901	p-gluk-2h	8526	0.0011%	833	0.00011%	9359	6617	0	6617
902	fp-reninm	8525	0.0011%	235	0.00003%	8760	6017	182	6112
903	s-infli	8505	0.0011%	2653	0.00034%	11158	3674	1256	4461
904	u-oksik-o	8472	0.0011%	21121	0.00273%	29593	4870	2186	6987
905	ab-hkr	8451	0.0011%	475	0.00006%	8926	5810	0	5810
906	s-pinp	8448	0.0011%	295	0.00004%	8743	4618	259	4740
907	u-baktseu	8444	0.0011%	85084	0.01098%	93528	2492	0	2492
908	-inabrsv	8444	0.0011%	99918	0.01289%	108362	7861	0	7861
909	s-smab	8420	0.0011%	28408	0.00367%	36828	6813	24831	30674
910	sy-neut	8394	0.0011%	1455	0.00019%	9849	5669	0	5669
911	p-ps	8394	0.0011%	365	0.00005%	8759	8052	339	8296
912	b-leuk-vt	8359	0.0011%	679	0.00009%	9038	4758	0	4758
913	ua-hbo2sat	8322	0.0011%	184	0.00002%	8506	8309	0	8309
914	u-trama-o	8247	0.0011%	36134	0.00466%	44381	5490	12223	16719
915	s-hcg-o	8247	0.0011%	37748	0.00487%	45995	4297	28240	32100
916	p-vwf-ag	8196	0.0011%	326	0.00004%	8522	4914	284	5087
917	fs-rf	8192	0.0011%	28282	0.00365%	36474	6996	0	6996
918	ly-t-cd4	8186	0.0011%	8044	0.00104%	16230	4479	4236	7852
919	b-qr-crp	8147	0.0011%	10641	0.00137%	18788	4211	0	4211
920	ly-cd4/cd8	8144	0.0011%	446	0.00006%	8590	3784	49	3832
921	u-baktjvi.	8099	0.0010%	59423	0.00767%	67522	5393	0	5393
922	fl-baktvr	8086	0.0010%	20125	0.00260%	28211	6305	0	6305
923	ly-cd4	8077	0.0010%	347	0.00004%	8424	3720	0	3720
924	ly-cd3	8076	0.0010%	348	0.00004%	8424	3720	0	3720
925	ly-cd8	8074	0.0010%	348	0.00004%	8422	3720	0	3720
926	ly-cd19	8067	0.0010%	351	0.00005%	8418	3715	0	3715
927	b-cd16/56	8066	0.0010%	358	0.00005%	8424	3712	0	3712
928	du-na	8066	0.0010%	2155	0.00028%	10221	6865	1775	7165
929	ly-cd16/56	8064	0.0010%	351	0.00005%	8415	3712	0	3712
930	s-lamotri	8027	0.0010%	370	0.00005%	8397	3942	322	4093
931	s-ovomuke	7935	0.0010%	3158	0.00041%	11093	5452	0	5452
932	cu-kesto	7913	0.0010%	781	0.00010%	8694	4508	0	4508
933	s-d-25-32	7878	0.0010%	110	0.00001%	7988	5525	0	5525
934	ex-tbvrvi	7794	0.0010%	25560	0.00330%	33354	2482	0	2482
935	glomerulussuodosnopeus,estimoitu,ckd-epi-kaava	7767	0.0010%	175	0.00002%	7942	5619	0	5619
936	u-intp	7744	0.0010%	460	0.00006%	8204	4125	361	4293
937	cu-tilav	7715	0.0010%	733	0.00009%	8448	4482	0	4482
938	ua-shco3	7701	0.0010%	135	0.00002%	7836	7690	0	7690
939	u-trisy-o	7697	0.0010%	33714	0.00435%	41411	5209	0	5209
940	s-tymidk	7690	0.0010%	679	0.00009%	8369	4386	543	4674
941	b-erytbl	7653	0.0010%	1859	0.00024%	9512	4011	0	4011
942	s-monab-o	7590	0.0010%	62639	0.00808%	70229	7260	61002	67393
943	inrvieri	7569	0.0010%	1034	0.00013%	8603	510	0	510
944	s-tyglab	7562	0.0010%	18040	0.00233%	25602	4859	8067	11937
945	-strjvi	7546	0.0010%	23095	0.00298%	30641	6909	45104	51583
946	b-bio-0	7447	0.0010%	72132	0.00931%	79579	7376	0	7376
947	s-adioni	7389	0.0010%	450	0.00006%	7839	5426	395	5716
948	p-glu/1h	7352	0.0009%	125	0.00002%	7477	4953	0	4953
949	s-ssbab	7349	0.0009%	32021	0.00413%	39370	6084	27483	33038
950	s-ucrp	7332	0.0009%	988	0.00013%	8320	5178	0	5178
951	-tilav.	7317	0.0009%	150	0.00002%	7467	6052	0	6052
952	s-cora14e	7309	0.0009%	1541	0.00020%	8850	6660	0	6660
953	as-eryt	7295	0.0009%	1778	0.00023%	9073	4346	888	5098
954	-amyl	7292	0.0009%	316	0.00004%	7608	1827	0	1827
955	l-blast-m	7285	0.0009%	1975	0.00025%	9260	3326	0	3326
956	s-c-pept	7262	0.0009%	2333	0.00030%	9595	5567	629	5795
957	s-immfix	7258	0.0009%	36845	0.00475%	44103	4944	23355	27851
958	cb-bepika	7221	0.0009%	1144	0.00015%	8365	3656	0	3656
959	alb-o	7210	0.0009%	48510	0.00626%	55720	3596	0	3596
960	s-testo-v	7179	0.0009%	477	0.00006%	7656	5777	431	5968
961	p-gluk,tk	7165	0.0009%	10292	0.00133%	17457	4525	0	4525
962	s-piiinp	7165	0.0009%	400	0.00005%	7565	4663	346	4859
963	s-cora9e	7165	0.0009%	1401	0.00018%	8566	6518	0	6518
964	du-kors-v	7154	0.0009%	272	0.00004%	7426	5475	260	5635
965	pt-fvspido	7143	0.0009%	111646	0.01441%	118789	6079	94902	100610
966	ab-o2-sis	7142	0.0009%	1354	0.00017%	8496	4510	347	4724
967	-cv19nho*	7136	0.0009%	5280	0.00068%	12416	5904	0	5904
968	ly-t-cd8	7123	0.0009%	753	0.00010%	7876	4106	638	4475
969	pt-papahpv	7093	0.0009%	4381	0.00057%	11474	5159	0	5159
970	cp-crp-lb	7038	0.0009%	2841	0.00037%	9879	4060	0	4060
971	ekg	7027	0.0009%	182	0.00002%	7209	3166	0	3166
972	-s.yht.	7003	0.0009%	112	0.00001%	7115	5854	0	5854
973	u-ni	6956	0.0009%	1470	0.00019%	8426	4100	1226	4945
974	b-gluk	6933	0.0009%	1692	0.00022%	8625	4621	98	4718
975	s-ebvabm	6930	0.0009%	36627	0.00473%	43557	6466	33378	39053
976	s-ebvabm	6930	0.0009%	923	0.00012%	7853	6466	33378	39053
977	s-afmaksa	6928	0.0009%	166	0.00002%	7094	6006	0	6006
978	-pyör.s.	6917	0.0009%	157	0.00002%	7074	5783	0	5783
979	pt-paino	6911	0.0009%	456	0.00006%	7367	1946	0	1946
980	du-normet	6860	0.0009%	525	0.00007%	7385	6108	489	6494
981	s-bopeaba	6851	0.0009%	13242	0.00171%	20093	6459	12901	19181
982	p-fvii	6821	0.0009%	265	0.00003%	7086	5942	234	6095
983	-pocabrc	6811	0.0009%	2744	0.00035%	9555	6197	0	6197
984	pt-gfreepi*	6804	0.0009%	249	0.00003%	7053	5309	0	5309
985	s-soijae	6801	0.0009%	7966	0.00103%	14767	6140	0	6140
986	s-adalimu	6790	0.0009%	324	0.00004%	7114	3249	0	3249
987	s-hasspäe	6777	0.0009%	322	0.00004%	7099	6158	0	6158
988	du-metnef	6729	0.0009%	628	0.00008%	7357	6040	571	6486
989	u-rakkoai	6725	0.0009%	127	0.00002%	6852	4471	0	4471
990	ts-pad-5tu	6720	0.0009%	18085	0.00233%	24805	6348	0	6348
991	s-dnaab	6714	0.0009%	9252	0.00119%	15966	4365	0	4365
992	s-ranao3e	6668	0.0009%	1778	0.00023%	8446	5807	72	5874
993	vb-vklaaja	6662	0.0009%	8246	0.00106%	14908	3886	0	3886
994	-pes.jäl	6644	0.0009%	230	0.00003%	6874	3450	0	3450
995	p-crp-poc	6595	0.0009%	3309	0.00043%	9904	2844	0	2844
996	s-ige2pöl	6553	0.0008%	210	0.00003%	6763	6015	0	6015
997	p-crp-p	6519	0.0008%	3584	0.00046%	10103	4489	0	4489
998	s-cmvabm	6495	0.0008%	36481	0.00471%	42976	5725	28477	33355
999	p-crpos	6444	0.0008%	4547	0.00059%	10991	3901	0	3901
